鸿蒙官方与深圳华秋电子有限公司战略合作共建鸿蒙技术社区，社区内容包括鸿蒙技术交流，课程等。公司持有华秋电子约9%股权，是否属实？	鸿蒙与深圳华秋电子有限公司正式合作，建立了一个包括鸿蒙技术交流、课程等内容的鸿蒙科技社区。该公司是否真的持有华秋电子约9%的股权？	1
董秘你好！公司以前称有电子烟雾化器核心技术，并称在电池和烟油上要有所突破，请问最近电池烟油等电子烟项目有什么新的进展？	董书记您好！该公司此前表示，它拥有电子烟雾雾化器的核心技术，需要在电池和烟草方面取得突破。最近的电子烟项目（如电池烟）取得了哪些新进展？	1
根据年报披露，合同负债可能对应订单比较饱满？但是存货又比较高，是什么情况？	根据年报中的披露，相应的合同负债订单是否已满？但库存相对较高。情况如何？	1
董秘您好，关于您前段时间说的氢能源上半年量产，目前为止氢能源销售怎么样，是否有订单合同	你好，部长？关于你前段时间所说的上半年氢能的量产，到目前为止氢能的销量如何？有订单合同吗	1
请问公司参股公司星昊医药终止IPO辅导，是何原因？该公司有何战略改变？是不是公司财务等有问题？	公司参股公司兴浩药业IPO辅导终止的原因是什么？公司的战略变化是什么？公司的财务有问题吗？	1
您好！贵公司的铝塑膜产品是否应用于宁德或比亚迪电池？谢谢！	你好您的铝塑薄膜产品用于宁德或比亚迪电池吗？非常感谢。	1
贵公司拥有价值3000亿的土地储备，能否出售一部分解绝债务？还有产业园智能化管理可以减少人员费。	你们公司有3000亿元的土地储备。你能卖掉一部分来偿还债务吗？工业园区的智能管理可以降低人员成本。	1
公司股东减持股份为什么不发公告，什么原因股东大量套现减持，请正面回应……	为什么公司股东没有就其减持股份的情况作出公告？股东们为什么大量套现并减持股份？请给予肯定的答复	1
骆总，您好，公司MLCC离型膜研发有些年了，现在到什么程序了?双星预计下半年开始生产，公司的产品是否又要落后了?是否会导致研发出来后市场容量不够?公司已是国资企业，能否改变以往民营时暮投拖拉的作风，做到早投产，出效益，重研发的可循环模式。	罗总您好，公司的MLCC释放膜已经开发了几年了。现在是什么程序？双星预计将于今年下半年开始生产。公司的产品又落后了吗？研发后会不会导致市场容量不足？该公司已经是一家国有企业。我们能否改变过去私人投资和拖延的风格，实现早期生产、效率和再研发的可循环模式。	1
请问贵公司哪些产品有出口？如果有出口，可以介绍一下出口产品名称、比重吗	你们有什么出口产品？如果有出口，你能介绍一下出口产品的名称和比例吗	1
最新股东人数？新项目推进情况？	最新股东人数？推广新项目？	1
您好!请问，公司销售人员在2019年大幅减少，是公司战略有调整吗？2020年公司销售人员只有6人，请问是公司目前已经不需要市场开拓了吗？谢谢	你好请问，2019年公司的销售人员将大幅减少。公司的战略是否有调整？2020年，公司只有6名销售人员。公司是否不再需要市场开发？非常感谢。	1
贵公司有MCU芯片相关业务吗？是封测还是设计？	你有MCU芯片相关业务吗？它是密封的还是设计的？	1
请问贵公司一直说订单很多,技术力量很雄厚,实力走在前列,为什么发展速度这么慢,净利润这么低?	贵公司一直表示，它有大量订单、强大的技术力量和领先的实力。为什么发展速度如此之慢，净利润如此之低？	1
上半年海运费用高涨且一箱难求，有无影响公司产品外销。	上半年，运输成本高，一箱难求，是否影响了公司产品的出口。	1
请问贵公司2015年1.5亿投资的香港医思医疗现在还持有多少股份？	2015年投资1.5亿元的香港易思医疗，您还持有多少股份？	1
主要产品有哪些呢	主要产品是什么	1
资本市场中像智动力这样长期跌跌不休的公司真不多，极大的影响了公司的形象，请问公司有何措施维护和提振公司股价呢？建议回购股票。	在资本市场上，像Smart Power这样长期下跌的公司并不多，这极大地影响了公司的形象。公司采取什么措施来维持和提高公司股价？建议回购股票。	1
董秘你好，河南灾情严重，公司作为一个食品龙头，请问有没有捐献相关产品来赈灾啊？	董书记您好，河南灾情严重。作为食品领导者，该公司是否捐赠了相关产品来赈灾？	1
请问董秘公司的客户是否有比亚迪集团？公司生产的产品能否应用于新能源汽车零部件？	秘书公司的客户是否拥有比亚迪集团？该公司生产的产品能否应用于新能源汽车零部件？	1
请问贵公司的经营状况是否有问题？为何不采取回购？	贵公司的运营有问题吗？为什么不回购？	1
你好，有人说公司产能利用率不足百分之五十是否属实呢？	您好，公司的产能利用率真的低于50%吗？	1
董秘你好，新能源行业的新赛道，贵公司在镍金属行业的业务有哪些，在镍金属行业贵公司有哪些业务	董书记您好，新能源产业新赛道，您在镍金属行业有哪些业务，在镍金属领域有哪些业务	1
请问董秘：股价跌到17元顾菁增持，跌到11元肖姣君增持，现在跌到5元了道是不见动静了为何？	对不起，董事会秘书：顾晶的股价涨到了17元，肖娇君的股价涨了11元。现在已经跌至5元。为什么没有消息？	1
董秘你好，汽车行业电动化和智能化已经成为不可逆转的趋势了，会有越来越多的汽车电子的订单，所以目前HUD的产能怎么样，一个月可以生产多少？后续有没有扩大产线的准备。	董书记您好，汽车行业的电动化和智能化已成为不可逆转的趋势，汽车电子产品的订单将越来越多。那么，HUD目前的产能是多少，一个月能生产多少？有没有扩大生产线的准备。	1
董秘您好，请问贵司是否拥有铈铁硼相关产品？谢谢。	你好，秘书，你有铈铁硼相关产品吗？非常感谢。	1
董秘，张榜看你司的招股书，建立在你司最终上市的原因是，国际声誉有一定影响力，是华南排名靠前的供应商，茂绩优秀，里外所渗透的就是你司很有实力。但你司股价自上市之日起便连续下跌，造成投资者严重损失，请问你司的回购计划是否需要提前启动？	董事会秘书张邦阅读了贵公司的招股说明书。贵公司最终上市的原因是其国际声誉具有一定的影响力。它是华南地区的顶级供应商，性能优异。你从内部和外部渗透的是你公司的实力。然而，贵公司股价自上市之日起连续下跌，给投资者造成严重损失。你需要提前开始你的回购计划吗？	1
董秘您好！公司产品大部分是销往国外的，这部分产品是在国内生产的还是在国外就地生产的。如果是在国内生产的，现在人民币升值是否会影响这部分产品的利润。谢谢！	董书记您好！该公司的大部分产品销往国外。这些产品是国内生产的还是国外本地生产的。如果在中国生产，人民币升值是否会影响这部分产品的利润。非常感谢。	1
请问5.20股东户数是多少	5.20年的股东人数是多少	1
董秘你好，我在市场上看见仲景六味酒和仲景鹿鞭酒，生产厂家为仲景集团，是否是贵公司产品？还是宛西集团旗下产品？如果不是贵集团产品为何不打假？请问贵公司对声誉是否重视？	董书记您好，我在市场上看到了中京六味酒和中京鲁班酒。制造商为中京集团。这是你的产品吗？还是万喜集团的产品？如果不是你的产品，为什么不打击假冒产品？贵公司重视声誉吗？	1
公司主要产品是螺纹钢吗	是公司钢筋的主要产品	1
你公司生产的miniLED是否可用于植物照明,目前产能如何?	贵公司生产的miniLED能否用于工厂照明？当前容量是多少？	1
董秘你好，请问公司子公司飞驰汽车分拆上市进度情况？大概什么时候上市？公司的燃料电池产量如何？有对外销售吗？	你好，董事会秘书，你能告诉我公司子公司飞驰汽车分拆上市的进展吗？它什么时候上市？公司的燃料电池产量如何？有外部销售吗？	1
公司核心技术人员接连出走，公司为什么不学习华为，分股份给核心员工，要想马儿跑，还得给马儿吃草。	公司核心技术人员相继离职。该公司为什么不向华为学习，并向其核心员工提供股份？如果你想让马跑，你就得喂它们。	1
最近股东人数是多少？	最近股东人数是多少？	1
贵司作为华为战略伙伴 有在设备上适配鸿蒙操作系统的规划吗？	作为华为的战略合作伙伴，贵公司是否计划在其设备上采用鸿蒙操作系统？	1
既然公司对于月子中心的发展前景持看好态度，公司自由资金仍有充足部分，何不把握住国家发展战略提前布局三胎，为公司发展打开新的盈利增长点呢？	既然公司看好月子中心的发展前景，而且公司还有足够的自由资本，为什么不把握国家发展战略，提前布局三大轮胎，为公司发展开辟新的利润增长点？	1
请问公司股权质押 平仓没？荣盛建设工程有限公司 1.8亿 14.90亿 30.00 4.14 五矿国际信托有限公司 荣盛建设工程有限公司质押股份给五矿国际信托有限公司 - 8.28 6.62 5.80 2019 09-30 - - 已达平仓线 2019	公司的股权质押是否已完成？荣盛建设工程有限公司有限公司1.8亿14.90亿3.0亿4.14五矿国际信托有限公司有限公司荣盛建筑工程有限公司有限公司将股份质押给五矿国际托管有限公司-2019年9月30日8.28 6.62 5.80-收盘线已达2019年	1
线上天猫超市和线下永辉超市等可以在南方售卖是因为他们是批发商 以买断的方式购买上市公司的产品，所以销售不受地区限制？	线上天猫和线下永辉超市可以在南方销售，因为它们是买断上市公司产品的批发商，所以销售不受地区限制？	1
请问公司，是否有c919相关业务？	公司是否有c919相关业务？	1
我看贵公司说蔚来汽车是公司的客户，请问贵公司与蔚来有哪些方面的合作？	我想贵公司说蔚来汽车是该公司的客户。贵公司与蔚来有什么样的合作？	1
请问智擎660目前可适用于自家哪些产品？预计可能提升百分之几毛利率？8月起量产，每个月产能有多少？可以替代百分之多少自家产品使用的芯片？每个月还有多少余量可以接受外部客户订单？谢谢！	智清660可以应用于哪些产品？毛利率的百分比预计会增加多少？自8月以来，每月的生产能力是多少？我们产品中使用的芯片有多少百分比可以更换？我们每月能接受外部客户的订单多少利润？非常感谢。	1
您好！请问贵公司大股东最近有没有减持的计划呢？	你好贵公司的大股东最近有没有减持股份的计划？	1
目前公司名表业务收入占比较大，而自有品牌业务成长性很一般，与公司发展战略不匹配，而且后续在全球疫情整体受控以后，随着国际旅行限制的逐步放开，其他地区（含香港）销售分流可能对公司名表业务增长造成极大冲击，请问公司有无制定相关措施来应对经营形势的总体变化。	目前，公司的名表业务收入占比很大，而自有品牌业务的增长很一般，与公司的发展战略不匹配。此外，在全球疫情得到整体控制后，随着国际旅行限制的逐步放开，其他地区（包括香港）的销售分流可能会对公司名表业务增长产生很大影响。不知公司是否制定了相关措施，以应对业务形势的整体变化。	1
董秘你好：同行业相比2020年度美的集团毛利713亿净利276亿，格力电器毛利439亿净利223亿，四川长虹毛利96亿净利0.45亿。请问董秘公司如此之低的净利润是如何做到的？	秘书您好：与2020年同行业相比，美的集团的毛利润为713亿，净利润为276亿，格力电器的毛利润439亿，净收入223亿，四川长虹的毛利润96亿，净收益4500万。秘书公司是如何实现如此低的净利润的？	1
请问董秘，公司与特斯拉的供应商认证有何进展或突破?	公司与特斯拉之间供应商认证的进展或突破是什么？	1
石墨烯电池实车量产测试开始了吗，20年底已到	石墨烯电池的量产测试开始了吗？20世纪末已经到来	1
请问5.30日股东户数 ，谢谢董秘	请告诉我5月30日的股东人数。谢谢你，秘书	1
您好！贵司收购的松下标的是否有空气热能汞相关技术专利？	你好贵公司的松下目标是否拥有任何空气热水银相关技术专利？	1
董秘：在历史性的发展机遇面前，贵公司是否有产业升级，进入车规级产品的规划？	董事会秘书：面对历史性的发展机遇，贵公司是否有计划升级其行业并进入车辆规格级别的产品？	1
请问，公司是否运营正常？是否有未披露应披露的重大信息？	对不起，公司正常营业吗？是否有应披露的未披露的重大信息？	1
九龙江集团选择在这个时点减持，公司有什么任何措施保护投资人利益？	九龙江集团选择在这个时间点减持。公司有哪些措施来保护投资者的利益？	1
请问，最新的股东人数？	最新的股东人数是多少？	1
贵公司1N战略什么时候同步到医美、牙齿、眼科等这些朝阳行业和布局黄金赛道？	贵公司的1N战略何时会与医疗美容、牙科和眼科等新兴行业同步，以及黄金赛道布局？	1
截止到6.5号公司股东人数	截至第6.5号公司股东人数	1
尊敬的董秘你好:请问贵公司的产品与大元泵业、凌霄泵业的产品有什么科技含量的区别？同类的上市公司还有几家？泰福泵业在泵业板块排名情况？谢谢！	尊敬的秘书，您的产品与大源泵业和凌霄泵业有什么区别？还有多少家类似的上市公司？泰富泵业在泵业的排名是什么？非常感谢。	1
你好，2020年公司铅酸蓄电池市场占有率达到48%，市场占有率会一路攀升。公司与众多整车企业合作为其提供铅酸蓄电池。请问公司切入低压锂电池是否有资源优势快速切入到整车厂的低压锂电池需求中去？谢谢	您好，2020年公司铅酸电池市场份额将达到48%，市场份额将一路攀升。该公司与许多汽车企业合作，为他们提供铅酸电池。该公司是否具备切入汽车制造商低压锂电池需求的资源优势？非常感谢。	1
董秘，您好！请问贵公司截至6月10号的股东户数，谢谢！	尊敬的秘书！请告诉我贵公司截至6月10日的股东人数，谢谢！	1
请问大股东质押的股票什么解除质押？	大股东质押的股份解除质押是什么？	1
5月订单和产能利用率如何？	5月份的订单和产能利用率如何？	1
公司股价一路下行，投资者情绪较低迷，请问公司有没有促进股价增长的计划，比如回购股票等？另外有没有保障投资者利益的计划	该公司股价一路下跌，投资者情绪低落。你有任何促进股价增长的计划吗，比如股票回购？有没有保护投资者利益的计划	1
日本企业暂停氢能源的发展对公司的氢能源战略有没有影响？公司如何评估氢能源发展？纯电动成为主流已清晰当年公司砍掉电池模块算不算战略失误？公司现还有纯电动模块的技术筹备吗？有没有可能用氢能源模块置换集团的微山稀土？	日本企业暂停氢能开发是否会影响公司的氢能战略？公司如何评价氢能的发展？很明显，纯电动已经成为主流。公司切断电池模块是不是一个战略错误？公司是否仍有纯电动模块的技术准备？用氢能模块替代微山稀土有可能吗？	1
你好董秘，截止今日股东数多少啊！	你好，秘书，截至今天有多少股东！	1
你好，董秘，请问贵公司分红比例都在当年利润的10%左右，即使利润丰年分红比例依然很低，现在都鼓励多分红，看公司也没有很多投资和扩张，公司对此如何考虑的呢？	你好，董事会秘书，我想问一下，贵公司的股息率约为当年利润的10%。尽管丰收年的股息率仍然很低，但我们鼓励现在支付更多股息。这家公司似乎没有太多的投资和扩张。你对此怎么看？	1
尊敬的董秘您好，贵司的新能源汽车部件布局如何？国内各领域装备订单疯涨，贵司的高端制芯装备订单情况如何？谢谢	尊敬的部长，您的新能源汽车零部件布局如何？中国各个领域的设备订单都在飙升。您的高端核心制造设备订单如何？非常感谢。	1
粤芯半导体作为公司的长期战略投资项目，未来是否基于粤芯半导体进军芯片设计领域，完善半导体上下游产业链？在四月份20年度业绩说明会上陈谨总裁表示已经向相关芯片设计产品项目团队进行全面考察调研，目前进行到什么阶段了？公司是否有收购芯片设计领域公司的意向？	作为公司的长期战略投资项目，未来广东半导体是否会进入芯片设计领域，以广东半导体为基础完善半导体上下游产业链？在4月的20年业绩展示会上，陈进总裁表示，他已对相关芯片设计产品项目团队进行了全面调查研究。现在是什么阶段？公司是否打算收购芯片设计领域的公司？	1
刘董您好请问，截至2021年6月30日，公司的股东数是多少？机构投资者持股比例为多少？谢谢	刘，截至2021 06月30日，公司股东人数如何？机构投资者的持股比例是多少？非常感谢。	1
请问贵公司是否有医疗美容方面的产品，公司在医美方面如何布局？谢谢	贵公司是否有医疗美容产品，公司在医疗美容方面的布局如何？非常感谢。	1
你好，请问贵公司草甘膦年产能是多少，占比贵公司业绩的百分之多少？贵公司什么时候公布半年报？谢谢	您好，贵公司草甘膦的年生产能力是多少，占公司业绩的百分比是多少？贵公司什么时候发布半年报？非常感谢。	1
董秘好，公司去年公告拟减持紫光股份的股票，请问现在进展如何呢？	你好，董事会秘书，公司宣布计划去年减持紫光股份。现在进展如何？	1
最新公告拟接受股权抵押，请问是否严谨，应为股权质押，请核实。	最新公告建议接受股权质押。请检查是否严格。这应该是股权质押。	1
请问，10月17日解禁的4.271亿股，主要由哪些机构或个人持有？	哪些机构或个人持有10月17日发行的4.271亿股？	1
亲爱的董秘你好，贵公司的蓝宝石产能在中国能占榜首吗？	尊敬的董书记，您的蓝宝石产能能否位居中国第一？	1
智暖岩板是保温产品，还是发热产品？	智暖岩板是保温产品还是取暖产品？	1
近日粤东近海的多个风电项目被延后一年实施，请问贵公司目前在手订单中，是否接到海上风电项目延后实施的通知？谢谢	最近，广东东部的几个海上风电项目被推迟了一年。您目前的订单中是否有海上风电项目延期的通知？非常感谢。	1
请问公司上市至今有做过增持，回购等呵护市场的具体行动吗？公司如何把握三年国企改革？	公司是否采取过任何具体行动来保护市场，如增持和回购？公司如何把握三年国企改革？	1
您好！当下医美行业大热，贵公司有没有往医美方面拓展业务呢，必竟公司很多业务和医美是相通和有优势的，谢谢！	你好目前，医疗美容行业非常火热。贵公司是否扩大了医疗美容业务？想必该公司的许多业务都与医疗美容相似，并具有优势。非常感谢。	1
6.18快到了，女人狂欢节，化妆品大卖！请问公司的产品有用到化妆品、降塑、医疗等包装上。谢谢	6.18快到妇女狂欢节和化妆品大甩卖的时候了！该公司的产品适用于化妆品、减塑、医疗和其他包装。非常感谢。	1
贵公司微信官微产品介绍子菜单点进去都刷不出来，请关注一下	您公司的微信官方微信产品介绍子菜单在单击时无法打印。请注意	1
你好，贵司新开设的TWK童装抖音直播有没有信心复制TW抖音店的成绩？最新的30天内TWK童装抖音店铺的销售额已经达到多少了？	您好，您的新TWK童装抖音直播是否有信心复制TW抖音商店的成果？TWK童装抖音店最近30天的销售额达到了多少？	1
请问董秘，截止目前贵公司股东数量是多少？公司国内有无盐湖提锂的订单？	到目前为止，贵公司的股东人数是多少？该公司有从盐湖中提取锂的国内订单吗？	1
贵公司今年海外市场有无订单斩获，是否恢复正常业务推广？	贵公司今年是否获得了海外市场的订单，是否恢复了正常的业务推广？	1
董秘您好！贵公司的产品有利于碳中和吗？还有今年养老产业发展与去年相比如何？	董书记您好！你们的产品是碳中和的的吗？与去年相比，养老产业的发展如何？	1
董秘你好，今年以来各行各业的原材料大幅上涨，请问贵司供应的各种特种材料有没有涨价，目前在核心技术领域的开发与应用有没有比往年业务有所突破？公司的题材和概念这么多，相关方面就没有任何订单业绩可公布？	你好，秘书，今年以来，各行各业的原材料都大幅上涨。贵公司供应的各种特殊材料的价格提高了吗？与往年相比，核心技术的开发和应用是否在业务上取得了突破？公司有这么多话题和概念，相关方面没有订单业绩需要公布？	1
请问贵公司有什么拿得出手的核心产品？是大麻，是疫苗，是中药？请回复	您有哪些核心产品？是大麻、疫苗还是中药？请回复	1
您好，请问公司有无廊桥相关产品。公司大股东山东机场集团济南机场T2航站楼建设已在筹备中，公司是否与山东机场有更加全面的合作？	您好，您有什么与廊桥相关的产品吗。公司大股东山东机场集团济南机场T2航站楼正在筹建中。公司是否与山东机场有更全面的合作？	1
董秘你好，请问下公司的酱酒产能每年是多少吨，谢谢	你好，部长？我们公司每年生产多少吨酱酒？非常感谢。	1
请问贵公司目前的硅片产能是多少？预计到2021年年底的硅片产能又是多少？	您目前的硅片生产能力是多少？到2021年底，预计的硅片生产能力是多少？	1
截止一季度末，公司总存货为多少？产品产销两旺，供不应求，库存为0吧？几个亿的库存卖光了按照公司历年毛利率也能赚1个亿左右！公司为什么一季度就不能增长50%以上呢？想不透，刻意隐瞒利润对投资者就是极大的侮辱和欺骗！！！	到第一季度末，公司的总库存是多少？产品的生产和销售都在蓬勃发展，供不应求。库存是否为0？如果数亿元的存货卖完，公司历年的毛利率也能赚1亿元左右！为什么公司第一季度的增长率不能超过50%？故意隐瞒利润是对投资者的极大侮辱和欺骗，这是不可想象的！！！	1
请问截止到2021年5月20日，股东人数是多少？谢谢！	截至2021 5月20日，股东人数是多少？非常感谢。	1
董秘辛苦了！请问贵公司产品有应用于5G建设中吗？	董书记辛苦了！您的产品是否用于5G建设？	1
董秘你好，贵公司有增加什么新业务板块？是否涉及装配式节能建筑	你好，秘书，贵公司增加了哪些新的业务部门？是否涉及装配式节能建筑	1
董秘好，请问公司产品是否有应用于c919大飞机？	你好，董书记，你能告诉我C919飞机上是否使用了该公司的产品吗？	1
请问京东物流在港上市,是否与贵公司的业务有相同之处?	京东物流在香港上市时是否与贵公司拥有相同的业务？	1
贵公司有没有考虑启用契合食品类产品风格的子品牌，比如：南极铺子、南极鲜、南极美味等等，谢谢！	您是否考虑过使用与食品风格相匹配的子品牌，如南极店、南极鲜、南极美味等。？非常感谢。	1
截止5月20日，公司的股东户数多少	截至5月20日，公司股东人数	1
您好，请问粤北钢铁变成韶钢基地，归属韶钢的利润是怎么样分配的？每年粤北钢铁的利润起吗增加超6亿元，年产三百万吨，每吨价格贴上韶钢标签要增加二百元以上！	您好，当粤北钢铁成为韶钢基地时，您如何分配属于韶钢的利润？粤北钢铁有限公司年利润增长6亿多元，年产量300万吨。每吨标为韶关钢铁有限公司的价格将上涨200多元！	1
董秘，你好。请问贵公司以合种方式入股迦智科技，占有多少股份呢？以后对公司业务有合影响？	你好，董书记。贵公司通过合资的方式在卡智科技拥有多少股份？对公司未来的业务有共同影响吗？	1
请问贵公司烧碱年产量是多少？	贵公司的烧碱年产量是多少？	1
董秘你好:现在国内猪肉价格低迷,公司可以发挥全球调配优势向猪肉价格高的国家出口,既能平抑猪肉价格,又能赚取利润,这是利国利全世界百姓的善事。	董书记您好：现在国内猪肉价格低了。该公司可以发挥其全球部署优势，向猪肉价格高的国家出口，既可以稳定猪肉价格，又可以赚取利润。这对国家和世界人民都是好事。	1
董秘你好，请问公司2021年上半年的经营情况如何，半年度业绩预告什么时候发布？	董事会秘书您好，2021上半年公司经营情况如何，半年业绩预测什么时候发布？	1
请问董秘，截止6月10日，公司的股东数量是多少。请不必担心，这并不是什么违规问题，其他绝大多数上市公司都是可以答复的。谢谢您 顺颂商祺。	我可以问问董事会秘书，截至6月10日，公司的股东人数是多少。请不要担心。这不是违规行为。大多数其他上市公司可以回复。谢谢你的问候。	1
请问一下董秘，公司生产的电解二氧化锰的主要用途是什么？公司现在的客户有哪些？潜在的客户有哪些？未来一年公司有没有产能翻倍的计划？请回复我们投资者，谢谢！	请问，局长，公司生产的电解二氧化锰的主要用途是什么？公司目前的客户是什么？谁是潜在客户？该公司是否计划在明年将生产能力翻一番？请回复我们的投资者，谢谢！	1
你好,比亚迪汉dmi什么时间上市?等待中	您好，比亚迪汉迪什么时候上市？等待	1
请问公司目前的股东人数是多少	公司目前的股东人数是多少	1
公司产品都是款清发货吗？我看公司2020年年度报告中应收帐款非常少？	公司的所有产品是否全部交付？我认为公司2020年年报中的应收账款非常少？	1
骆驼股份（601311.SH）7月22日在投资者互动平台表示，您好！公司投资建设动力锂电池回收和梯次利用工厂，近期规划产能为5万吨/年，会分期实施。感谢您的关注！ 期待公司锂电池回收占得先机！	骆驼（601311.SH）7月22日在投资者互动平台上表示，你好！该公司投资建设动力锂电池回收和梯级利用工厂。近期规划产能为5万吨/年，分阶段实施。感谢您的关注！期待该公司在锂电池回收方面处于领先地位！	1
贵公司在浦东新区有无业务开展？	你们公司在浦东新区有业务吗？	1
截止目前为止，该票股东数是多少？其中机构数是多少？	到目前为止，有多少股东投票？机构的数量是多少？	1
2021-04-23公告，航天高新（苏州）创业投资计划自2021-05-20至2021-11-19内减持不超过1070.5068万股，占总股本比例不超过0.39% 请问截止今天减持详细情况？	2021 04月23日公告：航天高新（苏州）创业投资计划自2021 05月20日至2021 11月19日减持1070.5068万股，占总股本的比例不超过0.39%。截至今天，降价的细节是什么？	1
董事长好 同业竞争希望能在你手上顺利进行 十年磨一剑 也该出鞘了 顺便问一下6月10日股东数多少？谢谢	董事会主席喜欢同业竞争。我希望这把十年之剑能在你手中成功磨练。顺便问一下，6月10日有多少股东？非常感谢。	1
请介绍下航天长征火箭技术有限公司航天电子信息产品产业化详细情况？	请详细介绍航天长征火箭技术有限公司航天电子信息产品产业化情况？	1
陈董你好！贵公司被国网电商并购之后，已没有进取之心了吗？而贵公司拥有的区块链技术怎不参与到国网电商主导的碳交易平台研发？还有，国网电商还有区块链公司，与远光的同业竞争怎么解决？而国网信通也一样有erp方面业务，不考虑将相关公司重组吗？	你好，陈先生！贵公司被国家电网电子商务收购后，是否没有进取心？但为什么你的区块链技术不参与国家电网电子商务主导的碳交易平台的研发？更何况，国有电商和区块链公司如何解决与远光的同业竞争？然而，中国网通也有erp业务。你不考虑重组相关公司吗？	1
公司高端ptfe目前产能多少，有无新增产能，价格趋势如何	公司高端聚四氟乙烯目前的产能是多少，是否有新产能，价格走势如何	1
您好，请您介绍一下近期越南公司的运营情况？比如单品或特殊品类客户需求有爆发式增长，是否满产满销，订单是否饱满，物流是否通畅，防疫工作等情况，谢谢	您好，请您介绍一下越南公司最近的经营情况好吗？比如，单品或特殊品类的客户需求爆发，产销是否满，订单是否满，物流是否顺畅，防疫工作，谢谢	1
请问，截至2021年5月31日，公司的股东数是多少？谢谢	截至2021 5月31日，公司股东人数是多少？非常感谢。	1
请问公司第六、七、九净水厂提标改造项目进展如何？	第六、第七、第九净水厂升级改造项目进展如何？	1
公司已经开始摸索面向直接客户的产品，不过面对直接客户名字必须有好听、易记、高大上的名字，例如可口可乐、美的，否则基本虎头蛇尾，公司品牌康源晨光感觉名字一般，东方晨光怎么样，年轻有活力	该公司已开始为直接客户开发产品。然而，直接客户的名字必须好听、容易记住、高大上，比如可口可乐和美的。否则，该公司的品牌康源晨光觉得这个名字一般。年轻有活力的东方晨光怎么样	1
请问，截止2021年6月10日，贵公司的股东数是多少，谢谢！！	截至2021 6月10日，贵公司的股东人数是多少？非常感谢。	1
请问公司PVC手套和丁晴橡胶手套订单情况怎么样，现有产能利用率能达到多少，公司大量新建产能于年内投产，是否存在大量产能投产后产能利用率过低风险?	PVC手套和NBR橡胶手套的订单情况如何，目前的产能利用率能达到多少，以及年内大量新产能投产后，产能利用率是否存在过低的风险？	1
尊敬的印董秘您好，上海现在是房地产调控最严格的城市，请问您所说的区域发展的战略机遇，是指哪一方面？比如说，浦东获立法权之类的具体的政策，谢谢！请印董秘能具体说明一下。	尊敬的尹书记，上海现在是房地产调控最严格的城市。你所说的区域发展战略机遇是什么意思？例如，浦东已经获得立法权和其他具体政策，谢谢！请具体解释。	1
请问贵公司三季度生产和销售是不是大幅下滑？飞流直下三千尺是贵公司走势的表现，公司是否还有动力？	贵公司第三季度的产量和销售额是否大幅下降？飞下3000英尺是贵公司趋势的表现。公司还有权力吗？	1
你好，董秘，请问截止6月23日股东人数是多少，谢谢？	你好，董事会秘书，截至6月23日，股东人数是多少，谢谢？	1
贵公司背靠腾讯和华为国内两大互联网巨头，希望贵公司能抓住这样的优势，不断发展壮大，而不是像现在股价腰斩一样	贵公司依赖腾讯和华为这两大国内互联网巨头。我希望你能抓住这一优势，继续增长，而不是将股价减半	1
请问贵公司为何产品不走向全国？很多人想喝很不到？李子园甜牛奶占领全国各地早餐店！烧烤店…..燕塘乳业为何不加大力度宣传和全国铺货？	你的产品为什么不销往全国？很多人想喝太多？丽子园甜牛奶占领全国各地的早餐店！烧烤店……燕堂乳业为什么不加大宣传力度，在全国范围内销售？	1
请问2021年7月底的股东人数多少 谢谢！	2021 7月末的股东人数是多少？非常感谢。	1
你好董秘:在互联网大数据时代,目前国际社会对网络安全越来越重要当下,请问贵公司在网络安全领域,有何战略布局、举措。	董书记您好：在互联网大数据时代，国际社会对网络安全越来越重要。贵公司在网络安全领域的战略布局和措施是什么。	1
请问公司是否与华为有业务上合作？有哪些关系？谢谢	公司是否与华为有业务合作？这些关系是什么？非常感谢。	1
请公布5月31日股东人数？	请于5月31日公布股东人数？	1
北京银行从2015年到今年整整6年，股价从15元多跌到现在4.9元，难道上市大股东不出来作过说法，为什么上市企业很少有资讯，随时与股民透明沟通公司经营情况，尽量用办法经营好企业，同时也去维护好股票价值。	自2015年起，北京银行的股价已从15元以上跌至今年的4.9元，整整六年。上市公司的主要股东难道不能说出为什么上市公司的信息很少，随时与股东透明地沟通公司的运营情况，同时努力管理好公司并保持股票价值吗。	1
公司股票价格一直都在底部区域震荡，请问公司未来还有什么好的发展规划设计吗？	该公司的股价一直在底部波动。公司未来有什么好的发展计划吗？	1
际华：你好，际华官网显示所属纺织印染企业主要产品包括棉纱、棉布、棉线、针织面料、针织成衣、服饰产品、染色布、帆布等，产品行销欧美等十多个国家和地区，今天棉花棉纱行情大涨，请问公司产能及销量如何？	吉华：您好，吉华官网显示，其纺织印染企业的主要产品包括棉纱、棉布、棉线、针织面料、针织成衣、服装产品、染色布、帆布等。产品销往欧美等10多个国家和地区。今天，棉纱市场正在飙升。公司的生产能力和销售量如何？	1
贵公司有计划回购股份吗？	贵公司计划回购股票吗？	1
董秘，请问今年有新车上市销售吗？	局长，今年有新车出售吗？	1
轨道交通,做为现代投资的第三大股东和实控股东国资委控股公司,持续增持现代投资股份,有没有最终增持比例目标?在增持中与现代投资有无沟通?	作为现代投资的第三大股东和控股股东，国有资产监督管理委员会（国资委）控股公司，轨道交通继续增持现代投资股份。是否有提高其持股比例的最终目标？在增持方面是否与现代投资有任何沟通？	1
董秘你好 公司有增持计划吗	你好，部长？公司是否计划增持股份	1
袁总 您好， 最近晨鸣纸业的股价一直喋喋不休，我们中小股民损失很大。请问公司最近生产情况正常吗？各纸种价格下降的厉害吗？请对二季度经营情况做一下简要介绍。谢谢	袁先生您好，晨鸣纸业的股价最近一直在喋喋不休，我们的中小股东损失惨重。公司最近的生产正常吗？各种纸品的价格是否急剧下降？请简要介绍第二季度的业务情况。非常感谢。	1
董秘，你好。请问公司 有没有 涉及 碳交易市场的相关业务？	你好，董书记。公司是否有与碳交易市场相关的业务？	1
请问公司刚签定的战略合作伙伴昆仑数智已经是公司的客户了吗，如果是今年已在该客户取得了多少订单	公司新签约的战略合作伙伴昆仑数智是否已经是公司的客户？如果是，今年从客户那里获得了多少订单	1
您好，请问截止7月20号，公司股东数为多少	您好，截至7月20日，公司的股东人数是多少	1
董秘您好，请问贵公司截止2021年5月28日股东人数是多少？	董事会秘书您好，截至2021 05月28日，贵公司股东人数是多少？	1
你好，请问张敏先生不是已经质押4700万股了吗？为什么在没有解押的情况下还能减持到4300万股呢？谢谢	你好，张敏先生质押了4700万股？为什么它可以减至4300万股而不被释放？非常感谢。	1
近日，华为斥资30亿成立了数字能源科技有限公司，而早在2018年公司与华为便签订了全面合作协议，双方将在数据中心直供电、信息化转型、新能源技术、企业人才培养和联合创新等领域展开全面合作。这会是公司与华为合作的新契机吗？	最近，华为投资30亿美元成立了一家数字能源技术公司。早在2018年，华为和华为就签署了全面合作协议。双方将在数据中心直供电、信息转型、新能源技术、企业人才培养和联合创新等领域开展全方位合作。这会是该公司与华为合作的新机会吗？	1
公司在17年布局了氢能请问现在持股比例是多少投了多少资金储能运输投了多少资金占比持股多少	该公司已于2017年分销氢能，目前的持股比例是多少？投资了多少资金？在能源储存和运输方面投入了多少资金？持股比例是多少	1
今年截止五月份，新增订单同期有增长么	截至今年5月，同期新订单是否增加	1
王代理董事长在会议中发言公司经营业绩上半年效率明显提升。上市公司对公司经营业绩并未公告情况下，王代理董事长是否违反信息披露规则。可能让中小投资者在信息不对等的情况产生损失，请加强学习及时纠正 谢谢。	王代理董事长在会上表示，公司上半年经营业绩的效率显著提高。如果上市公司尚未公布公司经营业绩，代理董事长王是否违反了信息披露规则。在信息不平等的情况下，这可能会导致中小投资者损失。请加强学习，及时纠正。非常感谢。	1
你好！请问截止6月20日公司最新股东人数是多少？	你好截至6月20日，公司的最新股东人数是多少？	1
请问贵公司5月底最新股东人数是多少?谢谢	截至5月底，贵公司的最新股东人数是多少？非常感谢。	1
请问截止，6月8日股东户数是多少	截至6月8日，股东人数是多少	1
为什么星云股份与宁德时代签署了大单，而公司没有，是因为研发投入太少，产品不过关吗？	为什么兴运有限公司与宁德时报签订了一份大订单，但公司没有，因为研发投入太少，产品没有通过标准？	1
您好董秘，作为公司的投资者，我想问下公司目前对于国家的双碳目标有什么响应，并且在环保行业对于未来有哪些竞争优势？	您好，秘书，作为公司的投资者，我想问公司目前如何应对国家双碳目标，未来在环保行业的竞争优势是什么？	1
董秘您好！请问近期纺机出口欧洲订单是否增加了？	董书记您好！最近对欧洲的纺织机械出口订单增加了吗？	1
您好，近期公司股价走势疲弱长阴不断，确实令投资者大失所望。请问公司目前产能充足、产销两旺，是否属实？如果属实，公司今年业绩是否将出现大幅增长？	您好，公司股价近期走势长期疲软，着实让投资者失望。该公司是否有充足的生产能力和繁荣的生产和销售？如果属实，公司今年的业绩会大幅增长吗？	1
公司的螺蛳粉业务和中石化相比有哪些不同？领导在广西考察肯定了螺蛳粉，公司是否有进一步做大做强这项业务的计划？	该公司的螺蛳粉业务与中石化有什么不同？领导在广西考察后确认了螺蛳粉。公司是否有进一步扩大和加强这一业务的计划？	1
您好：据说中国成年人有1/3人脱发概率，请问公司除了有用于脂溢性脱发除脂生发片药品以外，有没有储备或者有相关药品治疗脱发的喷剂，那样可以方便快捷的服务脱发患者，也可以快速提高公司盈利能力。谢谢	您好：据说1/3的中国成年人有脱发的可能性。除了治疗脂溢性脱发的药物（除脂肪生发片外），公司是否有任何治疗脱发的相关药物储备或喷剂，可以方便和快速地为脱发患者服务，并快速提高公司的盈利能力。非常感谢。	1
谭董您好，麻烦您提醒一下高管，分公司总经理，兼大股东张国英女士尽快减持，减持期时间不多来，三番五次的公告减持白纸黑字可不能儿戏，更不利于贵司的信用体系建设，谢谢	谭先生，您好，请您提醒高级管理人员、分公司总经理和大股东张国英女士尽快减持股份。还原期不长。白纸黑字地一再宣布减持不能成为笑话，也不利于你的信用体系建设。非常感谢。	1
您好，请问公司燃气具及其配套产品是否涉及到出口，如有出口的话主要是什么国家	你好，你能告诉我公司的燃气器具及其配套产品是否涉及出口吗？如果是，主要出口哪些国家	1
你好，请问贵公司苹果链业务在公司的业务里，占比是怎样的？	您好，贵公司的苹果连锁业务占公司业务的比例是多少？	1
董秘你好，请问现在股东人数多少	你好，部长？现在有多少股东	1
请问：贵司的家庭储能产品可以应用在屋顶分布式光伏发电系统领域吗？	请问：您的家用储能产品能否用于屋顶分布式光伏发电系统领域？	1
请问子公司天津有容蒂康在华南地区有哪些客户？	子公司天津优融通在华南有哪些客户？	1
6月17号，张董说，云锡已成为华为和中兴等企业的供应商，作为投资者想了解，贵公司主要提供什么类型的产品给上述公司？	6月17日，张东表示，云熙已成为华为、中兴等企业的供应商。作为投资者，您主要向上述公司提供哪些类型的产品？	1
请问贵公司在食品安全方面有什么成熟有竞争力的技术或产品	在食品安全方面，你们有哪些成熟且有竞争力的技术或产品	1
请问贵公司大股东减持股票什么时候能减完。还有多少没减	请问贵公司大股东减持股份的工作何时完成。还剩多少	1
董秘您好，截止5月28日公司公司股东人数是多少	你好，董事会秘书，截至5月28日，公司的股东人数是多少	1
请董秘公布至7月20日止流通股东人数，谢谢。2828	请董事会秘书在7月20日前公布流通股东人数。谢谢。二千八百二十八	1
公司已中标的金额有多少亿元？公司已接的订单金额大约是多少亿元？公司是否中标《中委合资广东石化2000万吨/年重油加工工程石油焦制氢装置项目双相钢S32750无缝钢管》，中标金额是多少？	该公司中标了多少亿元？公司收到的订单金额是多少？公司是否中标中委合资广东石化公司2000万吨/年重油加工项目双相钢S32750无缝钢管？中标金额是多少？	1
你好，请问截止2021年7月20日，公司股东人数多少？谢谢	您好，截至2021 7月20日，公司将有多少股东？非常感谢。	1
尊敬的公司领导:请问贵公司与华为有合作没?公司的发展目标和发展规划能给介绍一下吗?谢谢	尊敬的公司领导，您与华为有合作吗？你能介绍一下公司的发展目标和计划吗？非常感谢。	1
请问公司目前的产能利用率情况如何？覆铜板有没有涨价？另外之前募投的项目有没大面积的投产？	公司目前的产能利用率是多少？覆铜板的价格上涨了吗？此外，此前募集的项目是否已大面积投产？	1
董秘，这么小企业，减持这么多股票了不影响经营吗？？？	董事会秘书，这么小的一家企业减持这么多股份不是坏事吗？？？	1
董秘，你好，最近比亚迪出口欧洲一直有订单，请问贵司今年欧洲及别的国家出口情况有没有增长？谢谢	你好，董事会秘书，比亚迪最近一直在向欧洲出口订单。你认为今年欧洲和其他国家的出口有增长吗？非常感谢。	1
请问公司给阳光电源的供货产品有哪些？这些产品是定制品还是通用品？是否说明公司在谋求转型？	该公司向阳光电力供应哪些产品？这些产品是定制的还是通用的？这是否表明该公司正在寻求转型？	1
董秘您好，截止5月31日公司股东人数是多少	你好，董事会秘书，截至5月31日，公司的股东人数是多少	1
为什么这么久不回复问题了呢？请公司回购股票，或管理层增持股票，维护中小投资者利益。	你为什么这么久没有回答这个问题？要求公司回购股份或管理层增持股份，以维护中小投资者的利益。	1
刘董，您好！据说公司已经接到罗罗的首批订单，为何不见公司发公告？	你好，刘先生！据说，该公司已经收到了罗罗的第一批订单。公司为什么不发布公告？	1
对于中钰和晨牌的问题公司一直说要以公告为准，但如果不准算不算虚假陈述？公司投资5个亿进去，连个懂事都不派正常么？晨牌的股权转让没有进任何的股交所，如何转让？	对于中宇和晨湃的问题，公司一直表示以公告为准，但如果不允许，这是假的吗？如果公司投资5亿元，连董事都不正常吗？晨晨品牌的股权转让尚未进入任何证券交易所。如何转移？	1
董秘你好，面对原材料价格的波动情况，贵司产品最近是否有提价计划？	局长，您好，面对原材料价格的波动，您最近有没有提高产品价格的计划？	1
研究euv光刻机有相关这方面的专利吗	是否有与euv光刻机研究相关的专利	1
请问贵公司有涉及织布机业务吗？	贵公司从事织机业务吗？	1
董秘您好，截至7月30日公司股东户数是多少？谢谢	你好，董事会秘书，截至7月30日，公司的股东人数是多少？非常感谢。	1
董秘您好！作为铁粉股东最后还有一条建议，很多消费者及投资人不知道厨邦是一家上市公司，更不知道中炬高新是一家以调味品为主营业务的公司，将公司的名称和股票代码印刷在产品的外包装上可以起到很好的宣传作用！	董书记您好！作为铁粉的股东，还有最后一个建议。很多消费者和投资者都不知道楚邦是一家上市公司，更不知道中炬高新是一家主要经营调味品的公司。在产品的外包装上印刷公司名称和股票代码可以起到很好的宣传作用！	1
请问，公司股价半年来一直不振，大股东此时选择减持，是否考虑了二级市场的影响，市值管理是不是只是一句口号，或是大股东本就不看好公司后续发展？谢谢	不好意思，公司股价已经低迷了半年，大股东选择在这个时候减持。你考虑过二级市场的影响吗？市值管理只是一句口号，还是大股东不看好公司后续发展？非常感谢。	1
公司3月2日公告股东三峡新能减持的计划,目前减持时间过半。能否披露一下三峡新能目前的减持状况。谢谢!	3月2日，该公司宣布了股东三峡新能减持股份的计划。目前，缩减时间已超过一半。你能透露三峡新能目前的减持情况吗。非常感谢。	1
4月到6月的尿素，甲醇产量分别是多少？	4月至6月尿素和甲醇的产量是多少？	1
请问公司张家港二期项目和淮安项目新增产能应用于新能源汽车吗?	张家港二期项目和淮安项目的新增产能是否会应用于新能源汽车？	1
面对当前形势及市场环境，公司是否有回购或者增持计划？	面对当前形势和市场环境，公司是否有回购或增持的计划？	1
请问公司如何应人民币汇率升值问题？会不会对公司产品产生影响？	公司如何应对人民币汇率升值的问题？它会影响公司的产品吗？	1
请问董秘：贵公司目前业绩困难，公司打算如何扩大合作，来推广你们的产品和系统？	对不起，董事会秘书：贵公司目前在业绩方面遇到了困难。公司计划如何扩大合作以推广您的产品和系统？	1
中装建设同样是装饰公司，有做区块链业务，公司是否有涉及呢？	中庄建筑也是一家装饰公司。它做区块链业务。是否涉及？	1
董秘您好！请问公司餐饮事业部未来对全国以及世界的布局有什么计划吗？其销售模式是怎么样的呢？	董书记您好！公司餐饮事业部对未来的国家和世界布局有何规划？它的销售模式是什么？	1
请问公司的增强现实相关产品供货华为么？此外公司与华为公司还有那些合作呢 ？	该公司是否向华为提供增强现实相关产品？此外，华为与华为有哪些合作？	1
从贵公司网站看到有涉及光刻胶的原料，请问是否已和相关公司有业务往来？	从您的网站上，我们可以看到有与光刻胶相关的原材料。您是否与相关公司有业务往来？	1
您好，懂秘！我是你公司忠实粉丝，我持有公司股票三年了。我一直觉得贵公司是本行业龙头，那么请问？贵公司在这个行业有哪些优势？在上市公司概况上看到未来工厂针对那一领域？ADAS智能方向，和轮毂电机有哪些大的规划。	你好，知道秘密！我是贵公司的忠实粉丝。我持有公司股票已有三年了。我一直认为贵公司是这个行业的领先公司？贵公司在这个行业有什么优势？在上市公司概览中，您认为未来的工厂目标是什么领域？ADAS智能方向和轮毂电机的主要计划是什么。	1
请问贵公司在温州的工厂，面粉车间什么时候投产？谢谢	你们温州的工厂和面粉车间什么时候投产？非常感谢。	1
公司电子纸是否已应用数字货币相关产品？	公司是否将数字货币相关产品应用于电子纸？	1
董秘您好，请问公司锂电池是否满产满销，二厂二期和三厂一期的项目进展如何，何时可以贡献产能？	你好，董事会秘书，你能告诉我公司的锂电池是否已全部生产和销售，二期和三期工厂的二期和一期项目进展如何，以及何时能为产能做出贡献吗？	1
前面回答中表述，公司总部搬迁上海是基于未来发展战略……。战略是目标与手段的结合，请问：你提到的“战略”有什么具体的目标与手段？	如前一份答复所述，公司总部迁往上海是基于未来发展战略。战略是目标和手段的结合。你提到的“战略”的具体目标和手段是什么？	1
请问贵公司如何抓住欧洲的冬季消费市场？最近欧洲的家纺订单是否有所增加？	贵公司如何抢占欧洲冬季消费市场？最近欧洲的家纺订单增加了吗？	1
请问，截止5月31日公司的股东户数是多少？谢谢！	截至5月31日，公司的股东人数是多少？非常感谢。	1
你好，请问公司产品的发光材料是进口还是国产？价格相差多少？	你好，你能告诉我公司产品的发光材料是进口的还是国产的吗？价差是多少？	1
近几个月六氟磷酸锂快速涨价，请问贵公司对于长协议订单是采取协议期内价格不变的方式，还是采取缩量不锁价的方式？	最近几个月，六氟磷酸锂的价格迅速上涨。请问贵公司是否会在协议期内保持价格不变，或在不锁定长期协议订单价格的情况下减少交易量？	1
请问董秘:业内人士表示，154.53万吨可降解塑料的市场需求，仅仅是新政执行后，短期内增加的量，这远未达到可降解塑料的天花板。长期来看，可降解塑料存在千亿级的市场空间。泸天化在这个领域有研发、技术、生产的储备吗？可降解塑料和公司现有产业链相匹配吗？	对不起，董事会秘书：业内人士表示，154.53万吨可降解塑料的市场需求只是新政实施后的短期增长，远未达到可降解塑料上限。从长远来看，可降解塑料有1000亿的市场空间。鲁天华在该领域有研发、技术和生产储备吗？可降解塑料是否与公司现有的产业链相匹配？	1
董秘您好，辛苦了，请问截止5月31日收盘的股东人数，谢谢，祝工作顺利！	你好，董事会秘书？我想询问截至5月31日收盘的股东人数，谢谢，并祝您工作顺利！	1
现在国家放开三胎，请问贵公司有针对胎儿、幼儿、孕妇等群体研制相关产品或服务的计划？	现在国家已经开放了“三胎”政策。您是否有计划为胎儿、婴儿、孕妇和其他群体开发相关产品或服务？	1
建议公司加大产品宣传力度，提高企业知名度和产品知名度，改善业绩，同时请考虑改善市值，维护信誉。	建议公司加强产品宣传，提高企业意识和产品意识，提高业绩。同时，请考虑提高市场价值和维护声誉。	1
董秘你好,距离实施回购计划仅剩33个交易日了,是不是意味着公司将在这33个交易日内实施回购计划?	你好，部长，距离回购计划的实施仅剩33个交易日。这是否意味着公司将在这33个交易日内实施回购计划？	1
请问您公司激光设备目前产能及规划产能是多少?高、中、低产能分别是多少?	您的激光设备的当前和计划容量是多少？高、中、低能生产分别是什么？	1
董秘您好，请问贵公司的速冻产品与月饼有哪些原材料是相通用的，占比大概多少？	你好，董事会秘书？你们的冷冻产品和月饼常见的原料是什么，比例是多少？	1
比亚迪公司在整个电子和智能汽车领域发展很快，请问公司有跟比亚迪在合作吗？有产品在研发吗？	比亚迪在电子和智能汽车领域发展迅速。该公司是否与比亚迪合作？是否有正在开发的产品？	1
LTCC粉料公司是否有自主研发生产？还是采用进口粉料做生带的开发？	LTCC粉末公司是否有独立的研发和生产？还是开发用进口粉末制成的绿化带？	1
公司入股的兴工微是否通过华为供应商审核，感谢董秘百忙之余回复	该公司股东新工微是否通过了华为供应商的审查。感谢局长在百忙之中作出答复	1
您好！1月12日，正泰集团与华为正式签署合作协议。双方将聚焦产业数字化、网络化、智能化技术创新，共同推动能源电力及智能制造业务发展。本次华为数字能源公司发展战略中，相关技术合作贵集团是否有参与？	你好1月12日，正泰集团与华为正式签署合作协议。双方将聚焦工业数字化、网络化和智能技术创新，共同推动能源、电力和智能制造业务的发展。贵集团是否参与华为数字能源发展战略中的相关技术合作？	1
请问公司是否考虑在沿海城市布局钢铁厂？公司利用资金、技术优势，对外出口高附加值钢铁，公司充分利用发达国家疫情原因，加大高附加值钢铁产品的出口？	该公司是否考虑在沿海城市安排钢铁厂？公司充分利用资金和技术优势，出口高附加值钢材。公司充分利用发达国家的疫情，增加高附加值钢铁产品的出口？	1
1.2亿摄氏度“燃烧”101秒！中国“人造太阳”创造新世界纪录，请问公司产品在核聚变方面有应用吗？	在1.2亿摄氏度下“燃烧”101秒！中国的“人造太阳”创造了新的世界纪录。该公司的产品在核聚变方面有任何应用吗？	1
您好，请问，贵公司截止5月30日股东人数是多少？谢谢！	您好，截至5月30日，贵公司的股东人数是多少？非常感谢。	1
请问董秘产品是军用多还是民用多	你能告诉我部长的产品是更多地用于军事用途还是民用用途吗	1
酒香也怕巷子深，公司近期有没主动邀请机构投资者到公司调研，传递公司核心价值和发展理念的具体行动？另外，有关饮料项目的战略合作伙伴，公司有没有工作专班在负责推进？	酒香也怕巷子深。公司最近是否邀请机构投资者到公司进行研究和具体行动，以传递公司的核心价值观和发展理念？此外，公司是否有专门的团队负责推广饮料项目的战略合作伙伴？	1
请问，截至2021年7月30日，贵公司股东户数是多少？	截至2021 7月30日，贵公司的股东人数是多少？	1
公司旗下那么多的足球学院，有否考虑制作一款中国的足球游戏？	公司旗下有那么多足球学院在考虑制作一场中国足球比赛吗？	1
您好。公司加工生产的饲料有供应哪些养殖企业？ 公司的饲料产品相比与海大集团的饲料有哪些优缺点？	你好公司加工生产的饲料供应给哪些养殖企业？与海达集团的饲料产品相比，该公司的饲料产品有哪些优势和劣势？	1
董秘您好！请问今年以来大宗商品价格同比大幅上涨，对公司现在的产能及利润影响如何？当下有什么解决方案？谢谢！	董书记您好！今年大宗商品价格同比大幅上涨对公司目前的产能和利润有何影响？目前有哪些解决方案？非常感谢。	1
请问贵公司目前拥有多少项技术专利？	贵公司目前拥有多少技术专利？	1
公司与华为有合作吗？产品是否应用于鸿蒙系统中。	该公司是否与华为合作？产品是否用于鸿蒙系统。	1
董秘您好，截止6月30日，请问公司股东人数是多少？谢谢！	你好，董事会秘书，截至6月30日，公司的股东人数是多少？非常感谢。	1
董秘您好，请问公司有涉及牙科用品、牙科医疗或牙科健康方面的业务吗？	你好，秘书，你有与牙科产品、牙科医学或牙科健康相关的业务吗？	1
请问能公布5月31日的最新股东人数吗？不会又要本人持证件千里條條去马坝吧？互动易里很多公司都可以直接告诉韶钢是特殊公司？	你能在5月31日公布最新的股东人数吗？你不想带着证书去马巴，是吗？互动伊利的很多公司都可以直接告诉绍钢，这是一家特殊的公司？	1
董秘你好： 公司智能水表产品的配套软件系统都是自己开发的吗？公司的软件著作权和专利分别有多少？公司的全系列智能产品都可以适配华为鸿蒙吗？ 作为万物互联的一大场景水务计量，祝公司乘风而起，大有可为。	董书记您好：公司智能水表产品的配套软件系统都是自主研发的吗？公司拥有多少软件版权和专利？华为鸿蒙能适应公司所有的智能产品吗？作为万物互联、水表的一个大场景，我希望该公司能够顺风而起，大有可为。	1
您好,贵公司现在定单情况怎么样?	你的订单怎么样？	1
董秘您好，请问截止2021年7月9日，贵公司的股东人数是多少？谢谢	董事会秘书您好，截至2021 07月09日，贵公司股东人数是多少？非常感谢。	1
公司有碘片业务吗	这家公司有碘片生意吗	1
你好，贵司于2021-06-16发布的减持公告，持股5%以上股东2021-06-21开始减持，请问进展如何？已减持多少股？	您好，贵公司于2021 06月16日发布的减持公告显示，持有5%以上股份的股东于2021 06月21日开始减持，进展如何？减持了多少股份？	1
请问公司产品有适配鸿蒙系统或者吗	公司的产品是否适应鸿蒙系统	1
请问公司是否有汽车充电桩零件的研发和销售？占多少市场份额？谢谢	公司是否有汽车充电桩零部件的研发和销售？市场份额是多少？非常感谢。	1
董秘您好，贵公司新营业范围的新兴能源技术研发指的是什么？	您好，部长，您新业务范围内的新兴能源技术研发指的是什么？	1
请问公司最新股东人数是多少？	最新的股东人数是多少？	1
为什么上市公司在不缺钱的情况下，低价面向大股东非公开发行3.23元发行股票 筹资8.8亿，请问大股东如此低的价格购买股票，请问是否损害中小股东合法权益？请问独立董事在上市公司面向大股东定增，请问你们有没有维护中小股东合法权益？	上市公司在不缺钱的情况下，为何以323元的低价向大股东非公开发行股票，募集8.8亿元？我想问一下，大股东以如此低的价格购买股票，是否在损害中小股东的合法权益？我想问一下，独立董事是否在增加上市公司大股东的人数。您是否保护中小股东的合法权益？	1
尊敬的董秘，请问参股子公司珍珠红酒业有网络直播带货或者社区团购相关业务开展吗？	尊敬的董事会秘书，参股子公司珍珠酒业是否开展在线直播或社区团购相关业务？	1
贵司上市以后一直投资贵司，只因为当年在上海吃过巴比馒头，觉得性价比很高，但是现在股价一直下跌，我做长期投资倒也无妨。 我想问的是，贵司有无回馈股东的计划，譬如像仲景食品这种为股东配送公司产品，谢谢。如果没有，我提个建议，为股东分发一下贵司拳头产品！	贵公司自上市以来一直在投资贵公司，只是因为你当年在上海有芭比馒头，认为性价比很高。但现在股价一直在下跌，所以我可以做长期投资。我想问问贵公司是否有任何回馈股东的计划，比如向股东分销公司产品的中京食品。非常感谢。如果没有，我想提出一个建议，将您的竞争产品分发给股东！	1
请问公司为何不能按月份公布股东户数？	为什么公司不能按月公布股东人数？	1
董秘您好，6.18股东人数？	你好，董事会秘书，6.18的股东人数是多少？	1
董秘你好，请问截止6月10日股东人数是多少？谢谢你	你好，董事会秘书，截至6月10日，股东人数是多少？非常感谢。	1
请问贵公司有没有考虑聘请工程院医药方面的院士帮助公司提升产品研发水平的规划？	贵公司是否考虑聘请工程院医学院士来帮助公司提高产品研发水平？	1
贵公司股票是两市砸得最狠的股票，别的股票都有许多创造历史新高的。根据相关部门要求，请董秘及时回复，公司今年会不会因巨额亏损退出股市？！	贵公司的股票是这两个市场中受打击最严重的股票，许多其他股票都创下了新纪录。根据相关部门要求，请董事会秘书及时回复。公司今年会因巨额亏损而退出股市吗？！	1
请问购买公司产品后，服务与保养费用如何？其次，假如公司产品使用10年，市场也就与三甲医院为主，在新产品销售不出去的使用周期中，公司如何保证盈利？	购买公司产品后的服务和维护费用如何？其次，如果该公司的产品已使用10年，市场将由三级医院主导。当新产品无法销售时，公司如何确保服务周期内的盈利能力？	1
5月31日股东户数多少？谢谢	5月31日的股东人数是多少？非常感谢。	1
董秘你好： 公司与达达签约合作了，在一线城市和省会城市到家业务能否考虑覆盖5公里～10公里？ 下载了公司的APP，也充值了，买公司产品时却被提示不在配送范围内。希望公司能够重视该问题。	你好，董事会秘书：公司已经与达达签订了合同。你能考虑在一线城市和省会城市覆盖5~10公里吗？下载了该公司的APP并进行了充值，但在购买该公司产品时被提示不要在分销范围内。我希望公司能注意这个问题。	1
请问董秘，公司旗下哪些产品今年有涨价？涨价幅度分别是多少？	请问，董事会秘书，今年公司哪些产品涨价了？价格上涨了多少？	1
请问股东数是多少。	股东人数是多少。	1
请问公司自2020年3月公告股权激励项目后，到现在一年有多，项目进度如何？	自2020年3月公司宣布股权激励项目以来，已经过去了多少年？项目进展如何？	1
农机是否是你公司主营业务	农业机械是否是贵公司的主要业务	1
您好，请问可以介绍一下宿迁高性能纤维项目建设进展？期待您的回答，谢谢！	您好，您能介绍一下宿迁高性能纤维项目的建设进度吗？期待您的回复，谢谢！	1
董秘您好，请问公司工业级磷酸对磷矿石的单耗多少，目前有多少工业级磷酸产能？	您好，秘书，公司磷矿工业级磷酸的单位消耗量是多少？目前有多少工业级磷酸产能？	1
董秘您好，请问截止2021年5月31日，公司的股东户数，感谢您每次及时回复和努力的工作！	您好，董事会秘书，请告诉我截至2021 05月31日公司股东人数，谢谢您每次及时回复和辛勤工作！	1
请问5月31日的股东户数？	5月31日的股东人数是多少？	1
请问公司一直以来在产业扩张是否都是十分看好产品的销售前景才发债融资大建厂房购置机械设备准备扩产，但最终为何都屡屡失败告终？	我想知道，在发行债券资助大型建筑厂购买机械设备以扩大生产之前，该公司是否一直非常看好其产品在工业扩张中的销售前景，但为什么它们最终屡屡失败？	1
请问董秘截止5月31日的股东人数，非常感谢！	我想询问截至5月31日的股东人数，非常感谢！	1
目前下游光伏产能扩张过快过大，导致终端需求严重超过原料供应。请问苏州晶银搬迁扩产后，目前产能多少，主要产品太阳能电池银浆产能有达到500吨吗，二期产能投入有计划开启吗，浆料产品相应是否有提价？	目前，下游光伏产能扩张过快过大，导致终端需求严重超过原材料供应。苏州京银搬迁扩建后的现有产能是多少？太阳能电池主要产品的银浆产能达到500吨了吗？是否有计划开始第二阶段的产能投入？糊状产品的价格是否相应上涨？	1
公司的股东回报规划中提到：公司股价持续低于每股净资产时，公司将促使控股股东、实际控制人通过二级市场增持、公司回购股份等措施，积极稳定公司股价。”目前公司的PB只有0.7倍左右，请问公司何时履行以上承诺？	公司股东回报计划中提到，当公司股价持续低于每股资产净值时，公司将通过二级市场增持、公司股份回购等措施，督促控股股东和实际控制人积极稳定公司股价。“目前，公司的PB仅为0.7倍左右。公司何时履行上述承诺？	1
公司控股子公司苏州苏高新能源服务有限公司是否有碳排放交易相关业务？谢谢，请简单介绍下	公司控股子公司苏州苏高鑫能源服务有限公司是否有碳排放交易相关业务？非常感谢。请简要介绍	1
下次解禁什么时候	下次禁令什么时候解除	1
公司决定今年聚焦游戏主赛道，为何在5月收购上海桑喆网络科技有限公司？这是一家主要做什么业务的公司？	该公司决定今年专注于游戏的主赛道。为什么在5月份收购了上海桑哲网络技术有限公司有限公司？这家公司的主要业务是什么？	1
尊敬的公司领导，你好！我是贵公司的一名投资者。我想问一下，在大宗材料上涨的背景下，公司如何应对才能使贵司产品的毛利率不至于下降？谢谢！	尊敬的公司领导，您好！我是贵公司的投资者。我想问，公司如何应对大宗材料的上涨，使您的产品毛利率不会下降？非常感谢。	1
尊敬的董秘，您好，请问贵公司近期主要产品出厂价多少？较去年同期涨幅多少？	尊敬的董事会秘书，近期贵公司主要产品的出厂价是多少？同比增长多少？	1
中铁公司的领导您好：我想咨询一下，中国中铁已经连续下跌5年，公司市净率长期低于1，我司是否最近考虑用自有资金增持？为了提醒公司管理层对公司的发展长期看好，管理层人员是否也考虑买入自家股票长期持有？谢谢。	中国铁路总公司领导您好：我想问，中国铁路总已经连续五年下跌，公司的市盈率长期低于1。我们公司最近是否考虑过用自有资金增持股份？为了提醒公司管理层，他们看好公司的长期发展，管理层是否也考虑购买自己的股票进行长期持有？非常感谢。	1
请问公司在印度采购的生产原料是否有断供风险，公司是否有库存，有库存的话可以支持多长时间的产能	我想问一下，该公司在印度采购的生产原材料是否存在供应中断的风险，该公司是否有库存，如果有库存，产能可以支撑多久	1
希望公司能认识到：基于国家安全上讲，华为鸿蒙操作系统未来会大规模的普及国内一切信息产业终端设备。不和鸿蒙系统合作，基本上就相当于封闭了自己，产品也就无从谈市场	希望公司能够意识到，基于国家安全，华为鸿蒙操作系统将在未来大规模普及所有国内信息产业终端设备。如果我们不与鸿蒙系统合作，基本上就等于关闭了自己，我们的产品也没有市场	1
公司研发中心在精麻药立项与研究方面有多年经验，请问，近十年，取得多少精麻药新产品的立项批件？取得多少临床批件，多少生产批件？	公司研发中心在精细麻醉药的建立和研究方面拥有多年的经验。在过去的十年中，获得了多少关于建立精细麻醉药新产品的批准文件？已获得多少临床批准和生产批准？	1
董秘，大基金减持，是否说明贵司已经成为世界第一，可以不用政策层面扶持了？另外，贵司近期业绩历史新高，贵司应该重视市值管理，贵司最大股东才占比12%，贵司应该回购股份，维护投资人利益！	董事会秘书，大型基金的减少是否意味着贵公司已成为世界第一，无法在政策层面得到支持？此外，贵公司最近的业绩创历史新高。贵公司应注意市场价值管理。只有你最大的股东占12%。你的公司应该回购股票以保护投资者的利益！	1
请问贵公司与华为公司有哪些业务方面的关系？	贵公司与华为之间的业务关系是什么？	1
小鹏回香港上市，募集资金140亿港币，公司产能上来后，是否也应该考虑港股上市募资，以缓解资金压力，并尽快推出具有优秀竞争力的新车型？	小鹏回到香港上市，筹得140亿香港元。在公司的生产能力上来之后，是否也应该考虑在香港股票中筹集资金，以缓解资金压力，并尽快推出具有良好竞争力的新车型？	1
您好，请问贵公司有参加世界半导体大会暨南京半导体博览会吗？贵公司有哪些产品运用于半导体？谢谢	您好，贵公司参加了世界半导体大会和南京半导体博览会吗？贵公司在半导体中使用哪些产品？非常感谢。	1
董秘您好,大客户是不是推迟产品的上市时间了,导致贵公司的产品交付跟着延迟了?	您好，董事会秘书，产品的推出是否因一家主要客户的延迟而导致贵公司产品的交付延迟？	1
请问管理层，目前十亿以上大单品有几个？一亿以上单品有哪些？未来潜在冲击亿元和十亿以上规模单品储备大约有多少个？	管理层有多少超过10亿元的大型单一产品？超过1亿件是什么？未来有多少潜在影响达1亿元或以上的单一产品储备？	1
请问截止到5月20日，公司股东人数是多少？谢谢！	截至5月20日，公司的股东人数是多少？非常感谢。	1
请问董秘公司钨合金产品有无应用于军工方面项目 如脱壳穿甲弹等 谢谢	你能告诉我秘书公司的钨合金产品是否用于军事项目，如脱壳穿甲弹吗？非常感谢。	1
请问公司臂式产品对大客户的折让是反应毛利率的降低还是计入到销售费用，就是会计处理问题	公司手臂产品对关键客户的折扣是否反映了毛利率的降低，还是计入销售费用，这是一个会计问题	1
请问，公司主要进行哪些职业教育	公司主要提供什么职业教育	1
董秘，您好，请问贵公司到目前为止是否有未交付的有效订单？如果有，那么按照合同最近的交付时间截止到何时？谢谢！	亲爱的秘书，你有任何未完成的有效订单吗？如果是，根据合同，最迟的交货期限是什么时候？非常感谢。	1
股票百科里介绍公司是河北第一家机械行业上市公司。请问公司还有机械行业业务吗？没有的话叫他们改介绍吧。	根据股票百科全书，该公司是河北省机械行业第一家上市公司。该公司在机械行业有业务吗？如果没有，请他们更改介绍。	1
周董，贵公司对市场的反应还是太慢了！鸿蒙昨天已正式发布，结果股价暴跌，市场用脚投票！目前，国家的两大战略就是数字货币和碳达峰碳中和，请问鸿蒙所倡导的万物互联对这两大任务（目标）的实现有何推动促进作用？贵公司在这方面又做了哪些技术储备，取得了哪些成果？	周先生，贵公司对市场的反应还是太慢了！鸿蒙昨天正式发布。结果，股价暴跌，市场用脚投票！目前，我国的两大战略是数字货币和碳峰值和碳中和的。鸿蒙倡导的万物互联如何促进这两项任务（目标）的实现？贵公司在这方面有哪些技术储备和成就？	1
退城入园的巨资补偿款到位了嘛，另外在募资之后公司已经二季度利润暴增这笔补偿款有什么使用计划吗，且目前纺织业也行业景气度走高订单充足。	从城市返回公园的巨额补偿已经到位。此外，在筹集资金后，该公司第二季度的利润大幅增加。有没有计划使用这笔补偿金？此外，纺织业也正经历着一场繁荣。订单充足。	1
董秘，您好。请问截止7月20日收盘，最新一期的股东人数是多少？	尊敬的秘书。截至7月20日，最新一期的股东人数是多少？	1
请问公司是否有换电设施的供货或储备？	公司是否有电力交换设施的供应或储备？	1
公司股价七年新低，董事长说低估了，为何不采取回购增持行动呢	该公司的股价处于七年来的低点。主席说它被低估了。为什么不回购并增持股份	1
请问贵公司年中业绩预计如何？贵公司的明星产品在港澳台地区销量如何？	你的年中业绩预测是什么？你们的明星产品在香港、澳门和台湾的销售情况如何？	1
董秘您好！公司目前共持有江苏银行股票多少股？华泰证券股票多少股？	董书记您好！该公司目前持有江苏银行多少股份？华泰证券有多少股？	1
尊敬的懂秘您好，公司旗下工厂的生产线产能是否能满负荷生产？即产能利用率能否达到九成及以上？谢谢	尊敬的副部长，公司下属工厂的生产线能否满负荷生产？也就是说，产能利用率能否达到90%或以上？非常感谢。	1
您好，请问，贵公司截止7月10日股东人数是多少？谢谢！	您好，截至7月10日，贵公司的股东人数是多少？非常感谢。	1
请问公司的半导体集成电路级高纯绿色四甲基氢氧化铵显影液专用化学品开发”项目最新进展如何？光刻胶用显影液（极大规模集成电路用）”项目进展如何？什么时候开始供货？	公司的项目“高纯度绿色四甲基氢氧化铵开发半导体集成电路专用化学品”的最新进展是什么？“光刻胶（VLSI）开发解决方案”项目进展如何？货物什么时候可以买到？	1
董秘您好！新闻报道贵公司的分散染料已全部停产，请问是否属实？	董书记您好！据新闻报道，贵公司所有分散染料均已停产。这是真的吗？	1
请问大股东解禁期到了有考虑减持吗？	解禁后是否考虑减少大股东的持股？	1
公司的附产品氢气，年产值应该是6万吨，今年会更多，但是去年只销售了不到两万吨，剩下的4万吨呢。	该公司的副产品氢气的年产值应为60000吨，今年将更高。但去年，它只卖出了不到2万吨，剩下的4万吨。	1
贵公司在芯片和光伏领域是否立项并申请专利，利用相对应领域需要沉降到基材表面的物质去做实验和研究？	贵公司是否在芯片和光伏领域建立项目并申请专利，并在相应领域使用需要沉积在衬底表面的物质进行实验和研究？	1
董秘你好，请问贵公司产能利用率是否已经达到百分之百？在手订单还能维持满产多久？	你好，部长，你的产能利用率达到100%了吗？手头的订单能维持满产多久？	1
请问公司，针对近期公司股价低迷，大股东有无增持计划？	我想问一下，鉴于最近公司股价下跌，大股东是否有增持股份的计划？	1
您好！公司下半年将有部分产品的新产能陆续建成落地投产。请问这部分对全年利润贡献如何？谢谢！	你好下半年，公司将陆续建设并投产部分产品的新产能。这部分对年度利润有何贡献？非常感谢。	1
公司2月公告相关股东有大幅减持，是自身资金需求还是公司基本面已经变坏？目前减持情况如何？	2月，该公司宣布相关股东已大幅减持。是他们自己的资金需求还是公司的基本面恶化了？电流降低如何？	1
我是深圳贵公司的股东，我们在深圳核酸检测的是用金域公司的产品，请问贵公司的核酸检测产品有在深圳,东莞等地区使用吗？	我是深圳贵公司的股东。我们在深圳的核酸检测产品是金宇公司的产品。您的核酸检测产品是否在深圳、东莞等地区使用？	1
公司方便器项目是否有新项目，推广是否顺利	公司便携设备项目是否有新项目，推广是否顺利	1
请问公司最新的股东人数是多少户。谢谢	公司的最新股东人数是多少。非常感谢。	1
5G商用以后，公司的流量业务是不是有很大的拓展空间？公司业务在横向多元化上有什么考虑？融资资金打算如何使用？	在5G商用后，该公司是否有很大的空间扩展其流量业务？公司业务横向多元化的考虑因素是什么？融资资金打算如何使用？	1
尊敬的董秘： 最近蔚来汽车和贵公司续签了三年的制造合同，且产量小时安排上可见是连续翻班作业了。蔚来汽车已发公告，为何江淮迟迟不发公告，是故意隐瞒不报，还是信息披露达不到要求？ 谢谢！	尊敬的董事会秘书：最近，蔚来汽车与贵公司续签了三年的制造合同，从每小时的生产时间表可以看出，这是一种连续轮班作业。蔚来汽车发布公告。江淮汽车为何推迟发布公告？是故意隐瞒还是信息披露不符合要求？非常感谢。	1
请问董秘，截止2021年5月21日，公司股东户数多少？	截至2021 5月21日，公司股东人数是多少？	1
年报公司说加快公司主营业务战略定位，明确主营业务方向，加大扩展力度，迅速完成主营业务产业布局，实现规模与品牌双发展。年已过半，请问公司“主营业务”加快目前到了那里？方向又在那里？“产业布局”布局了什么？规模又体现在那里了？	公司在年报中表示，将加快主营业务的战略定位，明确主营业务方向，加大扩张力度，快速完成主营业务产业布局，实现规模和品牌双发展。半年过去了。到目前为止，该公司在哪里加速了“主营业务”？方向又在哪里？“产业布局”的布局是什么？秤又在哪里？	1
你好，请问大晶新材的光刻胶项目进展到哪一步了？怀化的光引发剂新的产线是否已完成立项？谢谢	您好，大井新材料光刻胶项目进展如何？怀化新的光引发剂生产线是否获得批准？非常感谢。	1
最近石油不断创新高，公司化工产品期货价格也大幅上涨，请问公司产品期现货价格对公司现货价格影响可大？	最近，石油不断创新高，该公司化工产品的期货价格也大幅上涨。公司产品的期货和现货价格对公司现货价格的影响有多大？	1
鲁伟鼎先生不参与具体的公司经营吗   战略方面他也不参与吗	卢伟定先生是否不参与公司的具体运营？他是否也不参与该战略	1
董秘您好，看到公司近期跟东风零部件签署了战略合作协议，请问其是否是公司客户？战略合作领域和项目有哪些？是否有新订单？	你好，董事会秘书。我看到该公司最近与东风零部件签署了战略合作协议。是公司的客户吗？战略合作的领域和项目是什么？有新订单吗？	1
公司有否考虑用衍生品公司生产世界杯类似的玩具？	该公司是否考虑使用衍生公司生产类似世界杯的玩具？	1
你好，贵公司有没有计划把产品拓展到全国的打算呢	您好，贵公司是否计划将产品扩展到全国	1
您好，董秘，公司在储能领域有何布局？谢谢	你好，秘书，公司在储能领域的布局是什么？非常感谢。	1
稳定股价，获取投资者认同，是汇洁股份管理层的职责，近期大比例分红后，公司股价持续下跌！本是利好却变利空  ，我们投资者很担心企业的经营现状，目前公司的经营状况是否正常，请告知！	稳定股价并获得投资者的认可是汇捷股份管理层的责任。在最近大比例分红后，公司股价持续下跌！我们投资者担心公司的经营状况。请告知我们公司目前的经营状况是否正常！	1
公司会开展碳中和业务吗？公司如何恢复景气，像个正常的公司?	该公司是否会开展碳中和的业务？公司如何像正常公司一样恢复繁荣？	1
请问远光的碳达峰、碳中和产品及解决方案与国家电网有限公司的碳达峰、碳中和行动方案有无关系？你们两家都有“区块链+碳达峰碳中和目标”十大场景，是否是同一个？国网雄安金融科技集团（国网电商）的首单5000万“碳金融”业务与你公司的有无关系，是否受益？	远光的碳峰和碳中和的产品及解决方案是否与国家电网公司的碳峰、碳中和的行动计划有任何关系？你们都有“区块链+碳达峰和碳中和目标”的十种场景，是不是都一样？国网雄安金融科技集团（国网电商）的第一笔5000万“碳金融”业务是否与贵公司相关并受益？	1
董秘您好！请问截止2021年7月10日公司股东数多少户，谢谢。	董书记您好！请告诉我截至2021 7月10日公司股东人数。谢谢。	1
请问，光学面板现在订单情况如何？	对不起，光学面板的订单如何？	1
尽快公布储能业务订单情况，没有订单，有实力也无济于事	尽快公布储能业务订单。如果没有秩序，没有力量是没有用的	1
请问贵公司产品目前是否考虑支持华为的鸿蒙系统？	贵公司的产品目前是否考虑支持华为的鸿蒙系统？	1
董秘您好，请问贵公司旗下宁波天一广场是否被授予“宁波市特色夜市街区”称号？目前国家大力提倡地摊经济，贵公司是否受益？	您好，秘书，您公司下属的宁波天一广场是否被授予“宁波特色夜市街区”称号？贵公司是否从当前州大力推行地摊经济中受益？	1
公司有无在量子技术方面的技术研究和储备？	公司在量子技术方面有技术研究和储备吗？	1
董秘：你好！感觉公司产品非常适合与社区电商合作，迅速占领市场，请问公司有与那些社区电商合作吗？	秘书：你好！我觉得公司的产品非常适合与社区电商合作，并迅速占领市场。你和那些社区电子商务公司有合作吗？	1
管理层好，请问公司的高牌号取向硅钢、高牌号无取向硅钢产品和宝钢股份相比，有什么优势？如何应对未来的竞争？	良好的管理。与宝钢相比，公司的高级取向硅钢和高级非取向硅钢产品有哪些优势？如何应对未来的竞争？	1
请问5月31日股东人数，谢谢！	请告诉我5月31日的股东人数，谢谢！	1
上市公司今年的军工采购金额普遍比往年增加，请问公司军工相关订单是否好于往年？	今年上市公司军购金额普遍高于往年。该公司的军事相关订单是否比前几年好？	1
请问董秘贵公司在国内同行业主要竞争对手是哪家公司？贵公司有什么优势？	在中国同行业中，东米贵的主要竞争对手是哪家公司？贵公司有哪些优势？	1
请问董秘，公司有没有适用于新能源汽车相关产品呢？	请问，秘书，公司有适用于新能源汽车的产品吗？	1
请问老师，E11品牌的生产线搭建好了吗？如果搭建好了，产能多少？	对不起，E11品牌的生产线准备好了吗？如果建成，容量是多少？	1
公司在6月30日股东人数是多少？	6月30日，公司有多少股东？	1
从哪个时间段的公告能查到2017年员工持股的减持情况？	从哪个时间段我们可以发现2017年员工持股的减少？	1
董秘好。请问贵司有否为国产919C大飞机生气供应发动机，如果有那在手订单是多少？谢谢！	好秘书。贵公司是否为国产919C大型飞机提供发动机？如果是，手头的订单是什么？非常感谢。	1
贵公司回购股份的情况如何了？最近股价跌跌不休，是不是没有回购呢？	你公司的股票回购怎么样？股票价格最近一直在下跌。没有回购吗？	1
董秘你好！公司年报显示有土地储备一千多万平米，华东分公司所在浦东新区土地储备有多少？国家在大力发展浦东，请问公司对这些土地储备准备怎样发展利用？	董书记您好！该公司的年报显示，其土地储备超过1000万平方米。华东分公司所在的浦东新区的土地储备是多少？国家正在大力开发浦东。公司将如何开发和利用这些土地储备？	1
董秘，您好！经查询，贵公司间接全资控股江苏南京苏盐酒业，请问苏盐酒业是否有酒类产品销售？如有，主要有哪些个酒类品牌？谢谢解答。	尊敬的秘书！经查询，贵公司间接持有江苏南京苏堰酒业的全资股份。苏堰酒业销售酒类产品吗？如果是，主要的酒品牌是什么？谢谢你的回答。	1
贵公司生产车载摄像头吗？销量怎样？	你们公司生产汽车摄像头吗？销售怎么样？	1
公司能否把股票名称改为公司的主营业务叫三星电表吗？现在的名称容易误导投资者？	该公司能否将其股票名称改为其主要业务三星安培计？现在的名字容易误导投资者吗？	1
请问贵公司到5月31日的股东人数和机构股东数	截至5月31日，贵公司股东和机构股东人数	1
请问公司有没有开发药酒产品的计划？	公司是否有开发药酒产品的计划？	1
董秘您好，有消息称集团大股东在6月18日股权解除质押5367万股，请问该消息属实吗？	你好，董事会秘书，有消息称，集团大股东于6月18日解除了5367万股的质押。这个消息是真的吗？	1
尊敬的董秘您好！请问贵公司目前拥有的煤矿和分别的产量具体情况是怎么样的？马莲台煤矿是否还在生产？红四煤矿完全正式投产后，总煤的产量大概有多少？	尊敬的秘书！贵公司目前拥有的煤矿和各自产量的具体情况是什么？马连台煤矿还在生产吗？红寺煤矿全面投产后，煤炭总产量是多少？	1
公司实控人是否有转让股份的意图？谢谢	公司实际控制人是否打算转让股份？非常感谢。	1
如果定增通过，近1年内减持的股东是否参加公司定增？	如果定增获得批准，过去一年减持的股东是否参与公司的定增？	1
你好，请问公司近期生产情况如何，同比是增还是减少？贵公司对苹果和华为的供应订单同比比较如何？公司智能装备基地施工、医疗器械扩产投入、电子烟良率和订单进展如何，烦请答复谢谢。	你好，公司最近的生产情况如何？同比增长还是下降？你如何比较苹果和华为的供应订单？公司智能设备基地建设、医疗器械扩产投资、电子烟产量和订单进度如何？请回复并谢谢。	1
从目前情况来看，没有订单，中期业绩还是很糟糕，对吧	从目前的情况来看，没有订单，中期业绩还是很糟糕的，对吧	1
请问公司2021年6月30日收盘的股东人数是多少	2021 6月30日，公司将关闭多少股东	1
请问截止6月18日收盘公司股东人数是多少，谢谢!	请告诉我截至6月18日公司的股东人数，谢谢！	1
董秘您好，请问贵公司参股公司武汉敏声核心产品通过测试了吗？项目进度在哪一阶段？	你好，董事会秘书，你们的股份公司武汉民生的核心产品通过测试了吗？项目进展到什么阶段？	1
若公司报表数据真实，那么强烈要求公司修改2020年度分配方案为每股派现金5元，或者回购公司股票1亿股注销！	如果公司报表中的数据属实，强烈要求公司修改2020年的分配计划，每股分配5元现金，或回购1亿股公司股份以注销！	1
请问截止至5月31日的股东人数是多少？	截至5月31日，股东人数是多少？	1
请问一下贵公司618销售战报怎么样？大概多少销售额？比其他增长多少？增长比较大的品类有哪些？谢谢！	你的618销售报告怎么样？大概的销售量是多少？比其他人多多少？增长相对较大的类别是什么？非常感谢。	1
董秘为何避而不谈6.9大量减持事项。所有股东都能看到有这个交割一直在操作。你们会看不见吗。希望正面回答这个问题。	为什么董事会秘书避免谈论6.9的大幅减持。所有股东都可以看到，这一和解一直在进行。你看不见吗。我希望正面回答这个问题。	1
听闻贵公司的KHZ和MHZ光刻产品都已产业化，并向市场供货，请介绍一下相关情况？	我听说贵公司的KHZ和MHZ光刻产品已经工业化并供应市场。请介绍相关信息？	1
你好，当前股东数多少？	你好，有多少股东？	1
董秘你好现在股东人数是多少，较上期是减少还是增加了	你好，董事会秘书，股东人数是多少？与前一时期相比是减少还是增加	1
您好，董秘。截止5月31日股东人数多少。	你好，秘书。截至5月31日的股东人数。	1
请问五月底股东人数多少？	五月底的股东人数是多少？	1
公司2020年1月豪言与华为合作的鹏霄服务器能年增收百亿元,目前看项目进度不近人意,公司对鹏霄还有信心么?	2020年1月，华为与该公司合作的公司鹏啸服务器可使其年收入增加100亿元。目前，项目进度不尽如人意。公司是否仍对鹏晓有信心？	1
全国每年生产销售两千多万辆汽车，公司的保险杠占比多少？	这个国家每年生产和销售2000多万辆汽车。该公司的利润占比是多少？	1
请问董秘,公司今年有没有和别的公司有过合作关系或战略布局。有没有新签合同,在节能上有没有新的创新和布局。请正面回答,谢谢	我想问董事会秘书，公司今年是否与其他公司有过合作关系或战略布局。是否签订了新的合同，在节能方面是否有新的创新和布局。请直接回答，谢谢	1
7月7日，2021世界人工智能大会创新应用展上，交通银行、工商银行、建设银行三家数字人民币运营机构均在展台中设立了数字人民币展区。这三家都有公司的产品，公司为什么不公告？请正面回答	7月7日，在2021世界人工智能大会创新与应用展览会上，交通银行、中国工商银行和中国建设银行在各自的展台上设立了数字人民币展区。这三家公司都有自己的产品。公司为什么不公布呢？请直接回答	1
董秘，您好！请问贵司产品是否有USB-C接口和配套生产产线、产能？如果有能否提供相关数据？	尊敬的秘书！您的产品是否具有USB-C接口，支持生产线和产能？如果是，你能提供相关数据吗？	1
你好感觉贵公司生猪销售跟不上呀能实现55～60万头的销售吗？	你觉得你的生猪销量跟不上55万到60万头猪的销量？	1
贵公司手握66亿未分配利润，近期有没有讨论一下高分红回报股东或者回购公司股票已彰显对公司未来的信心。	你们公司有66亿元的未分配利润。您是否讨论过高股息回报股东或回购公司股票是否表明了对公司未来的信心。	1
您好，请问后期6GWh的产能如何规划，电动二轮车需求疲软下主要增长点在哪里呢？在现有产能都没有满产的情况下如何消化掉这些产能呢？	您好，您如何规划后期6GWh的产能？在电动两轮车需求疲软的情况下，主要增长点在哪里？当现有容量未满时，如何消化？	1
董秘，你好！公司海南免税首店1月落地海南海垦广场，目前开始营业了吗？目前经营情况如何？据悉，海南离岛免税新政实施一年，销售额同比增长226%。公司海南免税店对公司业绩贡献多少？	董书记您好！该公司在海南的第一家免税店于1月在海南海肯广场设立。现在开门了吗？目前的业务状况如何？据悉，海南离岛免税新政实施一年后，销售额同比增长226%。海南的免税店对公司业绩有多大贡献？	1
贵司博满投资 投资的联创公司，投资的大中矿业。是否已经出售了大中矿业的股权？由于联创持股比例未达到5%不在法定通告范围，烦请告知	贵公司是Boman和一家大中型矿业公司投资的合资企业。你出售了大众矿业的股权吗？由于联创的持股比例未达到5%，请告知我们	1
请问董秘：1、是否在回答投资者问题时采用选择性回复？2、今年产能利用率能达到多少？3、下半年订单情况？4、公司基于什么原因撤销两家公司的挂拍？	对不起，董事会秘书：1.在回答投资者的问题时是否采取了选择性回答？2.今年的产能利用率是多少？3.下半年的订单状态？4.公司出于什么原因取消了两家公司的上市？	1
请问贵公司的三元锂电池与蔚蓝锂芯的电池有何不同，应用于哪些下游客户？产能及销量咋样？为何股价反映差别这么大	你们的三元锂电池和蓝色锂电池有什么区别，它们用于哪些下游客户？生产能力和销售量如何？为什么股价反映出如此大的差异	1
请问公司七月底股东人数，谢谢	请告诉我七月底的股东人数。非常感谢。	1
公司产品可以应用于光伏、新能源汽车领域吗？发展前景如何？	公司的产品能否用于光伏和新能源汽车领域？发展前景如何？	1
董秘，你好，股价持续创新低，而且已经跌破净资产，公司是否考虑回购股份？谢谢	你好，董事会秘书，股价继续创下新低，已跌破净资产水平。公司是否考虑回购股票？非常感谢。	1
公司想 成为一个让人尊敬的上市公司.就应该让公司业绩亮眼.股价也充分的得到体现.信息披露及时.缺一不可.目前看公司业绩一般.股价偏低.离尊重还实在遥远.请问.公司目前有没有引进战略股东的想法.请正面回答	如果公司想成为一家受人尊敬的上市公司，就应该使公司的业绩突出。股价也应该得到充分反映。信息披露是及时和不可或缺的。目前，该公司的业绩一般。股票价格很低。这远远不是尊重。我想问问公司是否有引入战略股东的想法。请给出肯定的答案	1
董秘您好，请问贵公司所研发生产的产品能否做到国产替代？	你好，董事会秘书，贵公司开发和生产的产品可以用国产产品代替吗？	1
您好！请问截至6月10号，公司股东人数是多少？谢谢！	你好截至6月10日，公司的股东人数是多少？非常感谢。	1
请问贵公司流片情况怎么样？是否开始盛产，有无接到订单	你公司的流媒体情况如何？是否开始生产和是否接收订单	1
除了大力发展和配套新能源电车业务，对于混合动力和燃料电池汽车，公司配套产品有无布局和研究？目前有无合作厂家和订单落地？公司是不是已经开发配套成功高性能新能源电机密封技术和产品，并批量供货？	除了大力发展和支持新能源有轨电车业务，公司是否有针对混合动力和燃料电池汽车的配套产品进行布局和研究？是否有合作制造商和订单？公司是否成功开发了配套的高性能新能源电机密封技术和产品并批量供应？	1
公司一直声称主要对标英飞凌，而自家产品确落后人家几代，给人感觉公司产品全国技术领先一样，是否存在故意误导投资者！	该公司一直声称主要针对英飞凌，其产品确实落后于其他几代。这给人的印象是，该公司的产品在国内技术领先。有没有故意误导投资者！	1
80万吨pp产能是宁波二期1线和2线的吗？东华扬子江是不是还有40万吨？	宁波二期1号线和2号线80万吨聚丙烯的产能是多少？华东长江还有40万吨吗？	1
您好，请问截止6月10日，股东户数是多少？谢谢！	您好，截至6月10日，股东人数是多少？非常感谢。	1
请问贵公司近年产品平均单价的趋势是什么样的，未来预期平均单价是什么样的？改指标在行业内处于什么水平	近几年贵公司产品的平均单价趋势如何，未来的平均单价预期是多少？行业指标水平如何	1
领导你好，请问我们公司截止7月30日的股东人数是多少？谢谢	各位领导，您好，截至7月30日，我们公司的股东人数是多少？非常感谢。	1
公司发展目标如果是中高端酒的话，建议公司多存老酒储备年份，开发六百以上至千元以上产品，和万元以上至十万元以上产品，把价格空间拉大，这样才能带动六百以上千元左右的产品，可参照舍得，祝公司早日跨入一二线高端酒行列！祝生意兴隆日进斗金！	如果公司的发展目标是中高端白酒，建议公司多积攒几年的老酒储备，开发600至1000元以上的产品，以及1万至10万元以上的，扩大价格空间，从而带动600至1000多元的产品，你可以看看舍得，祝愿公司早日跻身一二线高端白酒行列！祝你生意兴隆！	1
请问目前的股东数量	现在有多少股东	1
请问目前贵公司AR/vr除了在游戏方面有应用，其他方面的订单吗，比如远程通讯方面？	贵公司的AR/vr是否在游戏中有应用，但在其他领域（如电信）是否有订单？	1
您好！公司主营农产品有没有计划像金龙鱼一样做成国际一流农产品跨国公司？	你好是否有计划将公司的主要农产品打造成像金鱼一样的国际一流农业跨国公司？	1
截止到5月底的股东人数是多少？	截至5月底，股东人数是多少？	1
第二季度来，公司的风电叶片销售情况怎么样？是不是仍然满产满销？网上有在传公司子公司阜宁风电叶片订单锐减，不知是否属实？	第二季度风力涡轮机叶片的销量如何？它仍然是满产满销吗？网上有传言称，该公司子公司富宁风电叶片的订单急剧下降。我想知道这是不是真的？	1
目前C919主要用T300级别的，今年开始交付了，请问贵公司当下有没有参与C919的供货？	目前，C919主要为T300级，今年已经交付。您是否参与C919的供应？	1
公司的sic产品在入股国内产能最大的sic晶圆生产厂家天科合达及技术最成熟的sic衬底厂家瀚天天成后，解决了原材料及衬底生产工艺难点后，主要有哪些产品已经推向市场？	在公司的sic产品入股了中国最大的sic晶圆制造商天科和达以及最成熟的sic衬底制造商汉天成，并解决了原材料和衬底生产工艺方面的困难之后，哪些产品已经投放市场？	1
公司去年获得电子加速器订单超过80台，但年产能只有55台，产能和订单之间的缺口很大，公司如何保障尽快交付？另外，如果未来数年加速器订单仍然像去年一样高增长，那江苏的生产基地才投产就可能满足不了需求，公司有没有对此进行评估？	该公司去年收到了80多个电子加速器订单，但其年产能只有55台。产能与订单之间存在很大差距。公司如何保证尽快交货？此外，如果加速器订单在未来几年继续像去年一样快速增长，江苏的生产基地投产后可能无法满足需求。公司是否对此进行了评估？	1
天天科技质押给重庆公司1.425亿股股权质押到期日2021.5.31，是否已经解除质押请及时公告	天天科技向重庆公司质押1.425亿股股份。质押到期日为2021.5.31。请及时公告质押是否已解除	1
贵公司有参与数字货币桥项目的研究吗？或者贵公司有数字货币桥相关业务吗？	贵公司是否参与数字货币桥梁项目的研究？或者贵公司是否有数字货币桥相关业务？	1
董秘你好:建议公司采用加盟店模式扩大mini店和开设乡镇店。有如下优势：1.扩大公司影响力。2.扩大公司采购规模，进而降低采购成本。3.占用公司成本少。4.加盟模式经营灵活。5.巩固供应链环节的优势，进而区别社区团购	你好，董事会秘书：建议公司采用加盟店模式，扩大迷你店和开设乡镇店。它有以下优点：1.扩大公司的影响力。2、扩大公司采购规模，降低采购成本。3.减少公司占用的成本。4.加盟模式灵活。5.巩固供应链环节的优势，然后区分社区团购	1
董秘您好，酞菁蓝具有光伏效应，贵公司的产品是否应用于有机太阳能电池光伏电池？谢谢	董书记您好，酞菁蓝具有光伏效应。您的产品是否应用于有机太阳能电池光伏电池？非常感谢。	1
请问，公司产品TPO不能应用于光刻胶吗？宜昌官媒公开报导了。	对不起，该公司的TPO产品可以不应用于光刻胶吗？宜昌官方媒体公开报道。	1
十四五规划中提到加快国防和军队现代化，实现富国和强军相统一，航空航天装备订单放量，请问对公司的雷达业务有何影响？	“十四五”规划提到加快国防和军队现代化，实现富国强军统一，增加航天装备订单。对公司的雷达业务有什么影响？	1
请问贵公司是只为空军生产隐形战斗机相关的军工产品吗？海军以及陆军的军工特种钢制产品公司有没有涉及？，谢谢！	贵公司是否只为空军生产与隐形战斗机相关的军用产品？海军和陆军的军用特种钢产品公司是否参与其中？，非常感谢。	1
我国的铁路网十分密集，客流货运日益繁忙，从墨西哥轨道坍塌到台湾列车脱轨事故，开展轨道交通安全检查尤为重要。公司作为国内主要的轨道运维技术服务商，在这方面相比其他国家是否有突出优势？后期是否有能力保障国家铁路安全运营？	中国的铁路网非常密集，客流和货运日益繁忙。从墨西哥轨道坍塌到台湾火车脱轨事故，开展轨道交通安全检查尤为重要。作为国内主要的铁路运营和维护技术服务提供商，该公司在这方面是否比其他国家有突出优势？能否保证国家铁路后期的安全运营？	1
公司在新产品的开发上有哪些进展，比如智能化、电动挖掘机，电动装载机上有研究吗？现在隧道施工用的燃油机械使洞内环境极其差，如果有电动机械一定会使洞内空气质量改善不少。	公司在智能、电动挖掘机和电动装载机等新产品开发方面取得了哪些进展？现在隧道施工中使用的燃油机械使隧道环境极其恶劣。如果有电动机械，隧道内的空气质量将大大改善。	1
公司参展宁德新能源国际博览会，是否有相关新能源实体产品参展呢？	公司是否携相关新能源实体产品参加宁德新能源国际博览会？	1
