请问2021年9月30日公司最新的股东人数和机构持股情况，谢谢	您好，请告诉我2021年9月30日该公司最新股东数量和机构持股情况。谢谢。	1
“国务院办公厅关于鼓励和支持社会资本参与生态保护修复的意见”，公司是否有参与“生态保护修复”？是否有相关的业务？	“国务院办公厅关于鼓励和支持社会资本参与生态保护修复的意见”，公司是否参与了“生态保护修复”？有相关业务吗？	1
请问贵公司产品在光伏方面是否有应用	您的产品在光伏领域有哪些应用？	1
请问董秘，贵司年报本月28号披露，正常来说公布年报会提前一天，请问贵司是在本周五收盘后发布，还是周末发，或者是周一公布？另外本次年报是否会披露新扩建新能源汽车项目进度？	请问董秘，你本月28日披露的年报，通常年报会提前一天公布。在周五、周末或周一收盘后宣布它？此外，这份年报会披露新能源汽车新扩张的进展情况吗？	1
您好，请问，贵公司截止9月30日股东人数是多少？谢谢！	请问到9月30日，你们公司的股东数量是多少？谢谢。	1
董秘你好,公司生产的碘化钾是否能抗核辐射?	请问董秘，公司生产的碘化钾能抵抗核辐射吗？	1
贵司在机构调研时说：按照合同计划，现在比较大的订单交付验收会落在二季度， 如果订单按照计划交付，二季度业绩可能会有比较大的增长。我是看到相关信息才买入贵司股票的，但没有看到贵司大幅预增的公告啊！	贵公司在机构调查中表示，根据合同计划，第二季度订单发货接受度下降，如果订单按计划发货，第二季度业绩可能会有很大提升。我只是在看到相关信息时买下了你的股票，但没有事先看到你大幅增收的公告。	1
请问公司生产订单供不应求吗？	这家公司的生产订单不符合需求吗？	1
请问（1）公司的销售人员和研发人员各有多少人？   （2）截止到12.24日，股东人数是多少？	请问(1)公司有多少销售人员和研发人员？(2)截至12时24分，股东人数是多少？	1
董秘您好：请问截止到2022年3月10号，贵司股东人数是多少？	董秘您好：截至2022年3月10日，贵公司股东人数是多少？	1
请问公司现有多少玻纤产能多少？近期有拓产计划么？公司产品在100mw风电机组装机中用量多少吨？	该公司有多少玻璃纤维生产能力？有没有计划在不久的将来扩大生产？我们的产品有多少吨用于安装100兆瓦的风力发电机组？	1
申万宏源西部证券有限公司霍尔果斯亚欧路证券营业部连续三天通过大宗交易减持328万股，为什么没有公告	申万宏源西部证券股票有限公司霍尔果斯亚欧路证券营业部连续第三天通过大宗交易减持328万股。为什么没有公告？	1
董秘你好，公司产品可用于储能领域嘛？	请问董秘，公司的产品可以在储能领域使用吗？	1
董秘你好，半年报显示，公司研发了新一代泛终端管理平台，该平台管理的终端从有线智能终端扩展到5G+物联网终端。平台采用插件的方式快速适配目前国内主流物联网厂家的终端接入模式和协议，支持SaaS模式部署。目前，平台已完成百余款终端或设备的接入适配，在冷链监测、智慧楼宇管理等行业场景得到应用，这些有订单吗	你好，董秘。半年报显示，该公司开发新一代泛终端管理平台，管理从有线智能终端到5G+物联网终端的终端。该平台使用插件快速适配国内主流物联网制造商当前的终端接入模式和协议，并支持SaaS模式部署。目前，该平台已完成100多台终端或设备的接入适应，应用于冷链监控、智慧楼宇管理等行业场景。有这些订单吗？	1
20年公司培养基的产量为318480升，销量为73654升，产销率为23%。正常情况下，公司培养基产能远大于销售需求。请问公司21年培养基的产量为多少?	近20年来，公司培养基产量318480升，销量73654升，产销率23%。在正常情况下，公司的培养基生产可以远远超过销售需求。该公司21年的培养基产量是多少？	1
新冠病毒全球大流行，至今仍未见结束的任何迹象。公司能不能发挥自身在全自动显微镜形态学检验方面的优势，拿出破釜沉舟的勇气，助力全球抗击新冠疫情？考验公司高层智慧和胆略的时刻到了！	新型冠状病毒的全球大流行尚未结束。该公司能否充分发挥其在自动显微镜形态测量方面的优势，勇于破锅沉没，帮助全世界抗击新冠肺炎疫情？现在是考验公司最高管理层智慧和勇气的时候了！	1
董秘你好，深圳作为目前最具经济活力的城市，聚集了大量互联网人才。贵公司的竞争对手腾讯文档、飞书都在深圳招兵买马，步步为营。贵公司作为高度重视研发的企业楷模，是否有计划在深圳开设研发中心，提升研发力量，网罗第一流人才？	你好，董秘。深圳作为目前最具经济活力的城市，聚集了大批互联网人才。贵公司的竞争对手腾讯文件和飞书在深圳招聘人才。作为高度重视研发的企业典范，贵公司有没有计划在深圳开设研发中心，提高研发实力，招聘一流人才？	1
公司股价持续下跌，一众高管没人站出来增持自家股票？	该公司股价持续下跌，高管中也没有人增持股份。	1
公司进行转型，对“易华录”这个名称有没有改名计划，使股民更简单容易通过名称关联想到公司业务	这家公司正在经历转型。有没有计划改名为“易华录”，以方便股东通过其名称与公司业务联系？	1
公司有没有空气能热泵方面的产品或技术储备	公司是否有空气能源热泵的产品或技术储备？	1
公司有多少个独家品种？分别是哪些产品？谢谢	那家公司有几个独特的品种？产品是什么？谢谢你，谢谢	1
请问公司三季度的半导体设备产能如何？晶圆再生业务是否产生了收入?	该公司第三季度的半导体设备产能是多少？晶圆回收业务能带来收入吗？	1
公司是否有出口销售的渠道和路径？是否重视海外出口业务？	公司有没有出口销售的渠道和方法？贵公司重视海外出口业务吗？	1
控股股东变更快一年了，公司是否有考虑更改名称？	控股股东变更快一年了，公司有没有考虑过改名？	1
董秘你好，公司左旋肉碱用于哪些领域和产品呢？减肥、运动饮料等有吗？公司核心成品产品有哪些，核心优势呢？	请问董秘，L-肉碱在公司使用的领域和产品有哪些？有减肥、运动饮料等吗？公司的核心成品有哪些核心优势？	1
董秘你好，请问红杉清仓式减持的原因是啥？看公告显示自身资金需求，可解禁已经半年了也没减持完毕。众高管也是解禁半年也没减持结束，是真的资金需求还是有别的原因？	董秘，您好，红杉清仓减少的原因是什么？看公告显示自身资金需求，但解禁半年并未减少。许多高管们也又解除了半年的禁令，没有结束他们的持股。这是真的需要资金，还是有其他原因？	1
请问，截至12月10日公司的股东总数是多少？谢谢	请问到12月10日，该公司股东总数是多少？谢谢你，谢谢	1
琴宝，再问下键合丝的进展如何了，订单有多少。	秦宝，我再问一次线的粘接情况，订单多少钱？	1
董秘好，请问公司产品是否可用于或已用于全钒液流电池？	请问该公司的产品可以用于全钒液流电池吗？	1
你好，美国目前大搞基础设施建设，请问公司的产品有没有进入美国市场？	您好，美国目前正在从事基础设施建设，该公司的产品是否已经进入美国市场？	1
请问公司现有钴产品的产能是多少？	该公司现有的钴产品产能是多少？	1
董秘你好，目前贵公司订单和销售情况怎么样	董秘，您好。目前你们的订单和销售情况如何？	1
罗秘书您好，请问贵公司生产的空气净化器相关产品是否能检测空气当中的某些病原体或污染物，有没有相关指标能让我们预防和抑制类似新冠病毒等病原体在空气中的传播？谢谢	罗书记您好，贵公司生产的空气净化器相关产品能否检测到空气中的一些病原体或污染物？有没有能够预防和抑制新型冠状病毒等病原体在空气中的传播的指标？谢谢你，谢谢	1
请问数字货币在起步阶段，公司只有少量该业务收入很正常，但已获得入场先机，在冬奥会数字货币场景公司可有参与？另外公司与华为元宇宙实现数据打通，连通了虚拟世界与现实世界，这个有何重大意义呢？请指教，谢谢	请问数字货币在起步阶段，公司只有少量这样的业务收入是非常正常的，但是已经给了准入机会，公司可以参与冬奥会数字货币场景吗？此外，该公司与华为元巴斯实现数据连接，连接虚拟世界和现实世界有什么意义？请给我建议。谢谢。	1
您好、请问截止到2021年12月10日收盘的股东人数是多少呢？谢谢！	您好，截至2021年12月10日，截止日期的股东人数是多少？谢谢。	1
我们看到公司近期注册成立了深圳市云迈文体有限公司，请问公司投资文体业务基于什么发展意图考虑，因为一般人看起来这个业务与现在公司业务毫无关联。同时我们也看到公司参股博洋精密，请问参股博洋精密投资了多少人民币？	我们看到该公司最近注册成立深圳市云脉体育有限公司，我想请该公司根据怎样的发展意向考虑投资文体业务。因为普通人似乎与目前的公司业务无关。同时，我们也看到该公司参与博洋精密。博洋精密投资了多少人民币？	1
你们和中国能建合作的氢能源项目进展如何，，，	你与中国可以合作的氢能项目进展如何？	1
董秘你好，贵司股票联系下跌，请问有什么利空消息吗？截至目前大股东可以减持、质押、融券业务？目前股东人数多少？	你好，董秘。你的股票下跌了。有什么坏消息吗？到目前为止，大股东能否减少债券的持有、质押、借款？目前的股东数量是多少？	1
公司目前的产能11万吨是否都有长期订单匹配？产销率目前是多少？有多少产能是已经被长期订单锁定， 多少是随行就市的散单？	该公司目前10000吨的产能是否长期订单一致？现在的产销率是多少？长期订单确定了多少产能？随行市的大宗订单是多少？	1
请问截止到12月20日的股东总数？	能告诉我到十二月二十号的股东总数吗？	1
董秘您好，贵公司马来西亚项目明年上半年能够投产么？	董秘，您好。贵公司在马来西亚的项目可以在明年上半年投产吗？	1
你好感觉贵公司生猪销售跟不上呀能实现55～60万头的销售吗？	你好，我觉得跟不上你们公司生猪的营业额。你能实现55-600000头的销售吗？	1
董秘您好： 国内铁公基项目大量新建，对公司的产品销量是否有积极影响？ 公司的产品对比国内其他公司产品，有何竞争优势？ 公司上市后，大股东中国机械科学研究总院对公司是否有其他业务支持？	请问董秘：中国很多新铁公基项目对公司产品销售有没有积极影响？与国内其他公司相比，该公司的产品有哪些竞争优势？公司上市后，大股东中国机械科学研究院是否对公司有其他业务支持？	1
你好，请问贵公司产品是否有应用于新冠治疗药物	请问你们的产品是用来治疗新冠肺炎的吗？	1
公司产品能检测幽门螺杆菌吗？	该公司的产品能检测幽门螺杆菌吗？	1
请问公司现在在手订单有多少？分别集中在什么行业？感谢答复	你能告诉我公司现在订购了多少吗？他们专注于什么样的行业？谢谢您的回信。	1
请问公司，公司产品是否已经应用在特高压领域，具体是什么？	请问该公司的产品已经用于特高压领域了吗？这到底是什么？	1
请问公司主营业务是局限于高碑店市还是全国皆有布局呢？	请问该公司的主要业务是仅限于高碑店市，还是遍布全国各地？	1
董秘你好，公司跟电子烟巨头思摩尔国际有业务合作吗？公司的电子烟传感器已经批量生产出售了吗？	请问董秘，该公司是否与电子烟巨头西摩国际有业务合作？该公司的电子烟传感器是否量产销售？	1
截止4月8日股东人数是多少？谢谢	截至4月8日，股东人数是多少？谢谢你，谢谢	1
尊敬的董秘你好！ 贵公司参股山东东岳未来氢能材料股份有限公司的持股比例是多少？谢谢	尊敬的董秘先生您好。贵公司在山东东岳未来氢能材料有限公司的持股比例是多少？谢谢你，谢谢	1
最近公司的回购，回购结束后，会注销吗？	回购结束后，公司最近的回购会被取消吗？	1
贵公司今年海外市场有无订单斩获，是否恢复正常业务推广？	今年你们在海外市场有订单吗？你想恢复并推广正常业务吗？	1
董秘你好，公司经营是否出现重大问题	你好，董秘。这个公司的运营有什么大问题吗？	1
您好董秘！明年开始乘用车开始安装EDR，请问贵公司电源产品是否可以应用到该领域？此次政府主导机会贵公司是否积极响应并有无布局？！谢谢！	董秘你好。乘用车从明年开始安装EDR。贵公司的电力产品适用于这个领域吗？你的公司有没有积极响应，被安置在这个政府主导的机会上？谢谢。	1
请问公司如何充分利用这次冬奥会的机遇，进一步提高公司产品在冰雪产业中的市场地位？	公司如何充分利用冬奥会契机，进一步提升产品在冰雪行业的市场地位？	1
请问公司经营是否正常？产品销量是否下降？未来发展是否可持续可增长？研发投入占比如何？	公司运作正常吗？销售额在下降吗？未来的发展是可持续的还是可持续的？研发投入的比例是多少？	1
请问公司在医美行业的面膜产品，是否有出口到欧美国家？	请问该公司医疗美容行业的面膜产品是否出口到欧美？	1
请问贵公司有无核酸检验车产品？	有没有核酸检测的汽车产品？	1
董秘你好，疫情影响下，公司最近经营情况如何？资本市场的表现是否真实反映贵公司的经营管理现状？	你好，董秘。受疫情影响，公司近期经营状况如何？资本市场的表现是否真实地反映了贵公司的经营管理现状？	1
请问公司有辅助生殖方面的业务吗？	这家公司有辅助生殖业务吗？	1
请问2021年年底股东人数？	请问2021年底的股东人数是多少？	1
董秘你好，公司处于上中下产业链哪环呢，竞争对手和核心的优势几何	你好，董秘。那家公司在上、中、下游产业链中处于什么样的环？竞争对手和核心优势是什么？	1
董秘你好，请问贵公司的产品有无应用于医药中间体或者新冠治疗方面？具体展开列举一下，谢谢	您好，董秘，您的产品是医药中间体还是用于治疗新冠肺炎？请详细列出这个。谢谢。	1
首先感谢你们不辞辛劳的回复我们提出的问题。請問把带有时间和姓名的股票交易软件持仓截图和身份证一并扫描发送至公司邮箱，可以获知 非定期报告相关时点的股东人数吗？盼你们具体，明确答复。顺祝你们.，身体健康，万事如意, 【比如截至到2022年8月10日贵公司的股东人数是多少？】..	首先，谢谢你不厌倦地回答我们的问题。能否通过将有时间、姓名和身份证的股票交易软件截图扫描到公司邮箱，了解不定期报告相关时间的股东人数？我们期待着你具体而明确的答案。祝你身体健康。希望一切顺利。[例如，截至2022年8月10日，贵公司股东人数是多少]	1
请问公司是否有中长期规划储能项目，如抽水电站	该公司是否有中长期规划的储能项目，如抽水蓄能电站？	1
董秘好，公司作为宁德时代核心供应商，请问公司产品是否可用于或已用于客户的钠离子电池和麒麟电池？	董美豪作为宁德时代的核心供应商，该公司的产品是否已经可以用于客户的钠离子电池和麒麟电池。	1
请问公司8月初与中国计量大学合作，是基于对方已有专利技术吗？现在进展如何？谢谢。	8月初该公司与中国计量大学的合作是否基于对方的专利技术？现在怎么样？谢谢。	1
公司的光存储介质是否运用到碳中和、碳达峰的战略方向，紫晶存储有没有为政务数据灾备、档案、医疗、金融等领域的用户提供更丰富的应用场景	公司的光存储介质是否适合碳中和、碳峰的战略方向？紫晶储存在政府数据备灾、档案、医疗、金融等领域为用户提供了更丰富的应用场景吗？	1
董秘你好，请问公司在光伏建筑一体化方面有相关的产品吗？公司是否有参与光伏建筑一体化相关方面的建设？	请问董秘，请问公司在光伏建筑一体化方面有相关产品吗？该公司是否参与太阳能发电建筑一体化建设？	1
请问公司现在还有熔喷布生产和销售吗？近期疫情情况是否对熔喷布销售有明显影响？公司产品还有什么可以用在防疫物资上吗？如防护服等？	该公司还在进行熔喷布的生产和销售吗？近期疫情对熔喷销售有重大影响吗？防疫材料中还有其他可以使用的东西吗？比如防护服？	1
贵公司产品是否可以用在机床等工业母机上，同时氢气储能技术进展如何？	你们的产品可以用于机床等工业母机吗？储氢技术有什么进展吗？	1
董秘您好，请问华正新材是贵公司高频、高速覆铜板和77G毫米波PCB用覆铜板的主要供应商吗，谢谢	董秘你好。华正新材料是贵公司高频、高速覆铜板和77G毫米波印刷电路板覆铜板的主要供应商吗？谢谢你，谢谢	1
公司2020年的订单情况如何？	该公司2020年的订单情况如何？	1
您好，请问公司产品能否实现核排放监测？	请问该公司的产品可以实现核排放监控吗？	1
请问，截至2022年2月10日，公司的股东数是多少？谢谢	请问到2022年2月10日，该公司的股东数量是多少？谢谢你，谢谢	1
你好，请问截至11月19日公司股东人数是多少？谢谢	请问到11月19日，公司股东人数是多少？谢谢你，谢谢	1
看到公司三季度报中经营性现金流大幅减少的原因主要是为了平衡原材料加个波动，提前备货，但公司在招股书中所说的销售策略是赚取加工费用，请问原材料的涨跌跟公司销售收入关系大吗？公司是否改变了销售模式？谢谢	可以看出，公司第三季度报告中经营性现金流大幅减少的原因主要是为了提前平衡原材料和库存的波动，而公司招股书中阐述的销售策略是赚取加工成本。原材料的涨跌与公司的销售收入有多大关系？那家公司改变了销售模式吗？谢谢你，谢谢	1
请问，截止11月20日最新的股东人数是多少？望告知一下，谢谢	告辞了。到11月20日，最新的股东人数是多少？请告诉我。谢谢。	1
请问公司在解决上游核心原件自主，解决卡脖子问题方面，有何战略规划？	抱歉，公司必须解决上游核心的自主性。要解决瓶颈问题，战略规划是什么？	1
尊敬的董秘：         您好！        截止目前本月的10日，最新的股东人数是多少？感谢您的及时回复。	尊敬的董秘：你好？到本月10日的最新股东人数是多少？感谢您的快速回复。	1
董秘好，受手机、电脑等消费电子出货量放缓，以及缺芯影响，9月份以来，PCB板厂订单出现明显下滑，部分工厂缺单严重。请问贵公司的客户订单如何，订单是否饱满，对公司产品的采购需求是否出现下滑情形？	董美浩表示，由于手机、个人电脑等消费电子产品出货量放缓及核心短缺，9月以来PCB板厂订单大幅下降，部分工厂严重短缺。请问贵公司客户的订单是什么？点菜满了吗？公司产品的购买需求下降了吗？	1
你好，请问贵公司截止12月20日股东人数是多少。	请问到12月20日，贵公司的股东数量是多少？	1
尊敬的董秘，您好，请问截止1月20日，贵司股东户数是多少？谢谢。	尊敬的董秘，你好？截至1月20日，贵公司的股东人数是多少？谢谢。	1
贵司目前经营状况如何，中美会晤后，对贵司出口方面是否起到积极的带动作用啊。	贵公司目前的经营状况如何？中方与美方见面后，对你们的出口起到了积极作用吗？	1
请问公司产品是否可应用于机器人行业？谢谢！	该公司的产品可以用于机器人行业吗？谢谢。	1
公司产品市占率是多少	那家公司产品的市场占有率是多少？	1
董秘您好！公开信息显示首届全球数字贸易博览会是经党中央国务院批准的国家级、全球性、唯一以数字贸易为主题的专业性展会，是中国（浙江）自贸试验区扩区后国家赋予的重要战略平台。公司注册地址上海杭州，办公地址是上海，请问公司算是上海公司还是杭州的数字经济公司？	董秘你好。公开信息显示，首届世界数字贸易博览会是党中央、国务院批准的以数字贸易为主题的全国性、全球性、唯一的专业展会。中国(浙江)自由贸易试验区扩大后，是国家赋予的重要战略平台。公司注册地址为沪杭州，办公地址为上海。这家公司是上海公司吗？还是杭州的数字经济公司？	1
您好董秘，请问公司1月份新冠核酸检测盒、抗原检测、自测盒的产量各有多少？？	请问董秘，1月份新冠肺炎核酸检测试剂盒、抗原检测试剂盒和自测盒的产量是多少？	1
请问，截至十月 29日公司的股东总数是多少？谢谢	请问到10月29日，该公司股东总数是多少？谢谢你，谢谢	1
11月10号预解禁的原始股东增发股，增发价格是多少钱？	11月10日初步解禁的原股东增发股份价格是多少？	1
请问公司在一体化压铸有没有技术储备	公司在整个压铸上有技术储备吗？	1
公司有否考虑用衍生品公司生产世界杯类似的玩具？	该公司是否曾考虑过使用衍生品公司生产类似世界杯的玩具？	1
公司官网以及微信公众号 可否增加产品管线 临床试验信息等信息	公司官网和微信公众号是否可以添加产品流水线临床试验信息等信息？	1
请问董秘，中报中的非主营业务分析，有信用减值损失，高达1144万之多，请问委贷减值是哪部分贷款，如何造成的减值	请问董秘在对非主营业务的报告分析中，存在信用减值损失，达到1144万。请问贷款的哪一部分是手续费贷款的减值，减值是什么原因？	1
你好，有人说公司产能利用率不足百分之五十是否属实呢？	请问该公司的产能利用率真的在50%以下吗？	1
请董秘大大公布一下，截止到2022年1月20日的最新股东人数，谢谢！	请公布截至2022年1月20日的最新股东人数。谢谢。	1
公司产品对中药材行业科学健康发展有何意义？	该公司的产品对中医药行业的科学健康发展有何意义？	1
董秘您好，请问公司截止至30号的股东户数是多少？	董秘，您好，到30日，公司股东户数是多少？	1
远洋运输价格暴涨，公司鱼货是否通过自有冷藏运输船运输？远洋运输价格暴涨是否有提高了公司鱼货的竞争力？	海运价格飞涨，该公司的鱼商品是用自己的冷藏运输船运输的吗？海运价格的飙升提高了该公司水产品的竞争力吗？	1
董秘你好，请问贵公司的产品可以应用到智能穿戴，请问涉不涉及到元宇宙领域？贵公司业务有没有拓展元宇宙领域？	您好，董秘，您的产品可以应用于智能服装。它涉足了元巴斯领域吗？你的业务拓展了梅塔巴斯的领域吗？	1
公司的新冠唾液抗原已经获得欧盟ce认证 请问公司目前有收到唾液抗原订单么？	该公司新冠状唾液抗原已通过欧盟CE认证。该公司目前是否收到唾液抗原的订单？	1
董秘您好，请问截止12月20日收盘的股东人数，谢谢，祝一切顺利！	董秘你好。我想问一下12月20日收盘价的股东人数。谢谢。祝你一切顺利。	1
董秘您好。据您介绍公司目前与比亚迪等新能源汽车制造商的合作正有序进行，请问未来公司是他们的一级供应商还是二级供应商？此类业务的开展是否会对现有某些大客户的业务产生一定的影响？公司怎么评估这方面的风险与收益的？	董秘你好。据介绍，该公司与比亚迪等新能源汽车制造商的合作正在有序进行。未来的公司是他们的一级供应商，还是二级供应商？这类业务的发展是否会对一些现有大客户的业务产生一定的影响呢？该公司如何评估这一领域的危险和收益？	1
请问董秘，公司轨道钢材占比有多少？	告辞了。董秘，请问钢轨在公司的比例是多少？	1
董秘你好，公司是小米公司充电器主要供应商吗？	请问董秘，请问该公司是小米公司的主要充电器供应商吗？	1
请问截止11月30日公司股东人数一共多少户？谢谢！	截至11月30日，该公司股东总数是多少？谢谢。	1
请问贵公司有那些原料药适用新冠药物?目前有没有一亿元以上的大订单?	贵公司有哪些接口适合新冠肺炎？到目前为止有没有上亿元的大额订单？	1
董秘您好，恭喜贵企上市！请问公司的产品是否有用于新能源汽车、军工、光伏、航空航天领域？	董秘，您好，祝贺贵公司上市！该公司的产品是否用于新能源汽车、军工、太阳能发电、航空航天等领域？	1
董秘，您好，我想请问一下咱们公司的跨境电商业务在哪些电商平台上有？海外跨境电商业务占比多少？未来苹果不配充电线，公司是否为新品iPhone 13无线充电做好了准备？同时无线充电是否适配小米、华为等安卓手机。	董秘先生，请问我们公司有哪些电商平台有跨境电商业务？国外跨境电商占比是多少？苹果未来将不会部署充电码。苹果公司准备好为新款iPhone 13无线充电了吗？同时，无线充电是否适合小米、华为等安卓手机？	1
请问公司盐湖提锂矿项目有哪些产能！	请问该公司盐湖锂矿开采项目产能是多少？	1
董秘您好 请问公司前五大客户销售额占总销售额比例为多少？前五大客户都是哪些公司呢？谢谢	您好，董秘，前五名客户的销售额占总销售额的比例是多少？哪个公司是前五大客户？谢谢你，谢谢	1
公司在虚拟建造领域有什么样技术储备	该公司在虚拟建筑领域的技术储备有哪些？	1
你好，请问2021上半年订单状况如何，在手订单还有多少？谢谢回答。	您好，2021年上半年订单情况如何？你手头有多少订单？谢谢您的回信。	1
董秘您好，公司具有深厚的抗艾滋病原料药和中间体生产的技术储备，而利托那韦也是一款抗艾滋病药物，理论上讲，公司是否可以较易实现对利托那韦原料药或中间体的研发、生产？如是，公司是否考虑切入利托那韦生产线，以更好满足近期剧增的市场需求，从而为抗击新冠疫情做出更大贡献？	您好，董秘，公司在抗艾滋病原料和中间体的生产上有深厚的技术储备，而利托那韦也是一种抗艾滋病药物，理论上，公司能否简单实现利托那韦原料或中间体的研发和生产？若果真如此，该公司会否考虑切入利特纳维亚生产线，以更好地满足近期激增的市场需求，从而为打击新冠肺炎疫情做出更大贡献？	1
请问现时一套风电塔筒直接成本和费用各占销售额几成,一套完工时长多久,需要多少人员	目前，一套风电塔的直接成本和成本只占销售额的几个百分点，一套风电塔建成还需要多长时间？你需要多少人？	1
秘董你好！请问贵公司近段时间的生产订单如何？	你好，董秘方！最近的生产订单怎么样了？	1
董秘您好，下属四川新锂想公司的锂电池三元正极材料和前驱体是否已经投产了？能否介绍下产能规划或当前产能及客户情况？谢谢。	董秘，您好。四川新锂公司锂电池三元正极材料及前体生产了吗？能告诉我产能计划和现在的产能和客户吗？谢谢。	1
最近韩国腌制泡菜的成本大涨，请问公司的产品是否用于泡菜腌制？	最近韩国泡菜的价格高涨了。该公司的产品用来腌制吗？	1
请问贵公司和其它同行业的上市公司相比有什么优势和不足	与同一行业的其他上市公司相比，你的优势和劣势是什么？	1
您好，请问截止11月30日最新的股东人数是多少？望告知一下，谢谢！	您好，到11月30日，最新的股东人数是多少？请告诉我。谢谢。	1
请问截止到11月20日，公司股东人数是多少？谢谢！	截至11月20日，该公司的股东数量是多少？谢谢。	1
公司目前的产能与去年同期相比增长多少？利用率是多少？谢谢	与去年同期相比，该公司目前的产能增长了多少？使用率是多少？谢谢你，谢谢	1
请问一下公司现在的股东数,对比三季度的股东数量变化	你能告诉我公司目前的股东数量，并比较一下第三季度股东数量的变化吗？	1
东方电缆是公司的竞争对手吗？公司有无海工领域的业务？有的话主要涉及哪些海工业务？谢谢	东方电缆是该公司的竞争对手吗？这家公司在海洋工程领域有业务吗？如果是这样，主要涉及哪些海运业务？谢谢你，谢谢	1
董秘您好，请问贵公司订单如何？	董秘先生您好，您要点什么吗？	1
贵公司多年前一直是瓶片龙头，最近几年由于竞争对手不断扩大产能，餐食大部分市场份额。近期三期工程完工后，公司产能重回行业第一吗。	贵公司几年前就一直是塑料瓶薯片的领头羊，近年来，由于竞争对手不断扩大产能，贵公司在食品市场占有很大份额。三期工程近期竣工后，公司产能重回行业第一。	1
请问7.10公司股东户数？谢谢	请问7.10家公司的股东户数是多少？谢谢你，谢谢	1
基于现在的股价，请问公司是否有股份回购计划？	根据目前的股价，该公司是否有股票回购计划？	1
请问公司产品可以用在无人驾驶汽车上吗？	该公司的产品可以用于无人驾驶汽车吗？	1
尊敬的董秘您好： 请问截至11月30日的股东户数为多少？谢谢	尊敬的董秘您好：到11月30日为止，股东人数是多少？谢谢你，谢谢	1
您好，请问公司在可降解塑料领域的发展规划，公司已经或将取得哪些进展？谢谢！	您好，该公司在可生物降解塑料领域的发展计划将取得哪些进展？谢谢。	1
公司目前产能利用情况如何？？？有新闻报道，公司最近在厂人工将近万人，是否属实？？？请正面回答股东的问题！！！	该公司目前的产能利用率是多少？有报道称，该公司最近将在工厂雇佣近1万名员工。这是真的吗？请直接回答股东的问题！	1
您好，截止12/20，股东人数是多少？	请问到12月20日的股东人数是多少？	1
董秘你好,贵公司处于本行业产业链哪环。突出的“产品”有哪些和目前对手状况几何？主营占比几何。 谢谢	请问董秘，贵公司在这个行业产业链中是什么样的环？什么是优秀的“产品”？目前的竞争对手怎么样？主营业务比重。谢谢你，谢谢	1
贵公司产品有哪些优势！订单怎么样	你们的产品有什么好处？您要点什么吗？	1
请问贵司作为专精特新公司代表，后续如何做到汽车尾气处理方面的更加优秀公司？来逐步打破国外垄断地位，推广使用我们自主创新的产品？	请问贵公司作为新公司的代表，如何使公司在汽车尾气管理方面做得更好？逐步打破国外垄断地位，推广我国自主创新产品的使用？	1
董秘你好,公司有无军工订单业务?	请问董秘，公司有军事订购业务吗？	1
请问，根据贵司的招股书预告，十四五期间，公司根据目前的市场占有率测算2022年-2024年期间的营业额在33亿-50亿之间，但是贵司并未对目前市场上同类型产品的产品扩展情况机芯讨论分析，在产品未出现大的技术革新前提下，正常行业头部公司的市场占有率是逐步提升的,	对不起，根据你的招股书，14、5期间，根据目前的市场份额，公司预计2022年到2024年之间的销售额在33亿到50亿之间。但是，贵公司还没有对同类型产品在市场上的产品拓展进行讨论和分析。在产品没有重大技术创新的前提下，正常行业头部公司的市场份额逐步提升。	1
请问贵公司产品是否有应用于新能源汽车？	你的产品用于新能源汽车吗？	1
公司股价七年新低，董事长说低估了，为何不采取回购增持行动呢	该公司股价已创下七年来新低，董事长称其价值被低估，但为何不采取回购行动增持股份？	1
公司主要产品是螺纹钢吗	该公司的主要产品是螺纹钢吗？	1
你好，董秘充电桩用到本公司产品吗？	请问充电桩是用我们公司的产品吗？	1
请问募投项目进展如何？是否有投产项目或终止项目？	请问筹款工作是怎样的呢？有没有投产或终止的项目？	1
尊敬的高管好， 公司已投入在研的20G采样示波器项目对标国外同类高端产品，此示波器预计什么时候研发成功投向市场？填补国产替代空白！	尊敬的高管，公司已投资20G采样示波器项目，将国外同类高端产品标准化，预计示波器何时研发成功，可投放市场。填补国内替代空白！	1
董秘你好，公司特高压产品有无应用光伏，风能，储能方面？	请问董秘，请问公司特高压产品应用太阳能、风能、储能吗？	1
赶紧预告下业绩吧给投资者一点信心，股价跌狠了。特斯拉是公司客户吗？或者是新能源车有哪些客户，小鹏理想蔚来比亚迪？重庆工厂产能爬升到达几成了？明年能满产吗，是不是满产后再造一个华峰？	匆忙预测业绩，给投资者一点信心，股价大跌。特斯拉是公司的客户吗？或者，新能源汽车，小鹏理想比亚迪的客户是什么？重庆工厂的产能已经上升到多少？明年是满员，还是交割后再来一次华风？	1
公司属于精细化工行业，看公司有产品碳酸甲乙酯产品是可否用于锂电池电解液上？公司参股的圣持新材在锂电池电解液销量如何？	该公司属于精细化工行业，产品碳酸甲乙酯可以用于锂电池电解液吗？该公司新控股材料在锂电池电解液中的销售情况如何？	1
您好，请问贵公司是否生产电子烟领域相关产品。	请问贵公司生产电子烟领域的相关产品吗？	1
董秘你好，请问截止至8月11日的股东人数和机构数分别是多少？	董秘先生，您好，到8月11日，股东和机构各有多少？	1
请问，截至2021年10月29日，公司的股东数是多少？谢谢	请问到2021年10月29日，该公司的股东数量是多少？谢谢你，谢谢	1
请问公司有无加快提升产能计划？有无半年报预告？	该公司有没有计划加快提高产能？有半年一次的通知吗？	1
公司有edr产品吗	公司有EDR产品吗？	1
董秘您好请问贵公司和华为汽车有无实际合作，公司为特斯拉modelymodel3车型提供哪些产品。	您好，董秘，有没有与华为汽车的实际合作？特斯拉的ModelyModel 3车型提供哪些产品？	1
看起来公司目前处于成长期中,也很重视研发,是个不错的公司,请问公司在新产品研发方面有哪些规划？	这家公司正处于成长期，似乎非常重视研发，是一家不错的公司。新产品的开发计划是什么？	1
公司官网上溴已经为现货，卡龙酸酐为期货，是否代表公司具有这两种产品的生产技术和水平？谢谢	溴已在该公司网站有库存，碳酸酐为期货.这是否意味着该公司拥有这两种产品的生产技术和水平？谢谢你，谢谢	1
董秘您好，请问公司有涉及牙科用品、牙科医疗或牙科健康方面的业务吗？	请问董秘，贵公司有没有牙科产品、牙科保健或牙科保健方面的业务？	1
请问截止到11月19日的股东总数？	能告诉我11月19日之前的股东总数吗？	1
请问公司最近股价出现连续暴跌，请问公司现在的生产经营情况是否正常？客户订单情况是否正常？公司除了瑞声声学以外，有没有开拓其他几千万级别的大客户？公司有没有做好订单风险管控来规避瑞声声学的单一大客户风险？公司目前正在洽谈的激光器模组服务的客户有哪些？谢谢	告辞了。公司的股价最近暴跌了。公司的生产经营正常吗？您的订单正常吗？除了瑞声，该公司还开拓了成千上万的其他大客户吗？公司是否在做订单管理，以避免瑞声单一大客户的风险？该公司目前正在谈判的激光模组服务客户是什么？谢谢你，谢谢	1
唐总您好，（续）由于目前市场存在降关税预期，公司下游客户是否有出现推迟订单现象，对公司相关影响如何？谢谢	唐先生您好，(续)由于目前市场预期关税下调，企业下游客户下单是否有延误，对公司有何影响？谢谢你，谢谢	1
董秘您好，辛苦了，请问截止7月9日收盘的股东人数，谢谢，祝工作顺利！	董秘，您好。谢谢你努力工作。我想问一下7月9日收盘价的股东人数。谢谢。我希望工作的一切都顺利。	1
董秘你好 请问公司有做军工电子产品吗？	董秘，您好。这家公司生产军用电子产品吗？	1
请问，截至2021年12月10日，公司的股东数是多少？谢谢	请问到2021年12月10日，该公司的股东人数是多少？谢谢你，谢谢	1
您好！2020年,公司承接了多个省级5G通信工程设计项目,包括辽宁联通、天津联通、山东联通和内蒙古联通,辽宁移动、辽宁铁塔地铁5G覆盖等5G通信工程设计项目。2021年是否新增其他省份的项目，请问贵司5G项目订单是否充足，谢谢	您好！2020年，公司承接多个省级5G通信工程设计项目，包括辽宁联通、天津联通、山东联通和内蒙古联通、辽宁移动、辽宁铁塔地铁5G覆盖等5G通信工程设计项目。2021年还有其他省份的新项目吗？你的5G项目订单够了吗？谢谢。	1
董秘您好，请问截止10月29日收盘的股东人数，谢谢，祝一切顺利！	董秘你好。请问10月29日当天收盘的股东是多少钱？谢谢。祝你一切顺利。	1
您好，请介绍下公司现有的各种产能，以及新增的各种产能，投产时间。谢谢。	您好，请介绍一下公司现有产能，以及新增产能和投产时间。谢谢。	1
您好,请问公司何时复工复产,公司对疫情期间有何应对方法?目前公司订单有多少??	请问公司什么时候复产，应对疫情的公司做什么？那家公司现在有多少订单？	1
问下今年医保集采时间大概啥时候？公司产品受集采影响大不大？	请问今年医保的收取时间是什么时候？公司的产品受收藏的影响很大吗？	1
您好，董秘，最近元宇宙火爆，且看到很多同类MCU公司宣布自己的产品会应用到相关产业链，请问贵公司的产品是否也会应用到相关产业链？是否会应用到VR/AR当中？	您好，董秘密、梅塔巴斯最近很受欢迎，同样的MCU公司也很常见，宣布它们的产品适用于相关产业链。您的产品是否也应用于相关产业链？是否适用于VR/AR？	1
请问截止2021年12月10日收盘，公司的股东户数是多少？希望能够及时回复，谢谢。	截至2021年12月10日，公司股东户数有多少？我希望你能马上回复。谢谢。	1
公司招股书中披露有甲醇制氢车间，产量多少，谢谢	根据该公司的招股说明书，有甲醇制氢工厂。产量是多少？谢谢。	1
公司实控人是否有转让股份的意图？谢谢	公司的实际控制人是否有转让股份的意义？谢谢你，谢谢	1
公司上市以来，新设了很多控股51%的公司，为什么不是100%控股？公司是否对另外49%的交易对手有充分的考察，未来在拓展业务的过程中，是否还面临和较多的交易对手信息不对称的风险？	上市以来，51%的控股公司多成立了，为什么不设立100%持股呢？该公司是否充分审查了其他49%的交易对手，今后在扩大业务的过程中会不会面临更多交易对手的信息和不对称风险？	1
截止4月8日公司股东人数是多少？谢谢	截至4月8日，股东人数是多少？谢谢你，谢谢	1
尊敬的董秘你好！ 贵公司7月份产品有机硅价格从每砘3万元左右涨到9月份6万元左右，涨幅巨大是否对公司三季度业绩起到积极作用？谢谢	尊敬的董秘先生您好。贵公司产品的有机硅价格从7月份的每公顷3万元左右上升到9月份的6万元左右。这种大的增长是否对公司第三季度的业绩产生了积极的影响？谢谢你，谢谢	1
贵公司的爱克EXC-ECCP4.0云控平台能不能应用到元宇宙上面。公司和中青宝有没有建立战略合作关系。公司的各种专利能不能应用上虚拟VR上。	贵公司的IKE EXC-ECCP4.0云控制平台是否适用于元巴斯？公司与中青宝是否建立了战略合作关系。该公司的各种专利均可应用于虚拟VR。	1
近期各上市公司由于原材料价格上涨、人工及运输成本提高，都对自家产品上调了出厂价格，请问贵公司产品是否也相应对出厂价格进行调整？	近期，由于原材料价格、人工成本和运输成本的上涨，所有上市公司都提高了本公司产品的出厂价格。你们的产品也会相应调整出厂价格吗？	1
国家发布《“十四五”冷链物流发展规划》，贵公司拥有铁路冷链独特优势，招股说明书中也提到募集资金有投入冷链物流，请问目前是否有具体的发展战略部署、规划和调整？	国家发布“冷链物流发展第十四个五年计划”贵公司在铁路冷链方面具有独特的优势。招股书中还提到，资金投向冷链物流。目前有没有具体的发展战略、规划、调整？	1
董秘您好，公司有人脑工程方面的产品或技术吗	请问董秘，公司有没有脑部工程的产品或技术？	1
您好，请问董秘，中钢国际是否有电力行业低碳发展相关的业务或者订单？	请问董秘，中钢国际是否有涉及电力行业低碳发展的业务或订单？	1
您好，请问公司年产5万吨乳酸项目试车情况如何？预计何时可实现量产？谢谢！	请问年产5万吨乳酸项目投产情况如何？大规模生产计划什么时候实现？谢谢。	1
公司产品感觉高大尚，也很神秘，既然上市是就应该是公众公司，建议公司在合理合规的情况下作好信批。	该公司的产品觉得高贵神秘，既然推出应该是上市公司，建议公司在合理合规的情况下进行信守。	1
董秘您好 请问公司产品是否配置于新能源汽车或者智能家居用品？	您好，董秘，该公司的产品适用于新能源汽车吗？还是适用于智能家居产品？	1
公司电子纸是否已应用数字货币相关产品？	该公司的电子纸是否使用数字货币相关的产品？	1
董秘您好、如果吸入式获批，以公司的产能和准备，能否马上把它推入市场上？	董秘您好，如果吸入型获批，可以用公司的产能和准备，马上拿到市场吗？	1
董秘你好，请问在第三代半导体设备领域，贵公司是否有相应技术和产品？	董秘，您好。你们在第三代半导体器件领域有相应的技术和产品吗？	1
公司上半年没有预告中报业绩，请问年报会有业绩预告吗？看到很多公司的订单预喜希望公司能尽快出台年度预报，提高透明度，给投资者信心。	该公司未事先报告上半年业绩。年报有没有业绩预告？看到很多公司的订单，希望公司尽快发布年度预告，提高透明度，给投资者信心。	1
请问贵公司的主营业务收入大多在国外,在全球范围的疫情影响下,国外大概率面临金融危机,贵司是否尝试往国内转型?	我想问一下，贵公司的大部分主业务收入都在海外。受全球疫情影响，外国可能面临金融危机。贵公司是否在尝试向中国转型？	1
请问公司产品有应用在PMSM电机上吗?占公司主营比例多少？谢谢	该公司的产品是否用于永磁同步电机？公司的主营业务占多大比例？谢谢你，谢谢	1
公司的核心技术是什么，在行业内的地位如何？谢谢	公司的核心技术是什么，在行业中的地位是什么？谢谢你，谢谢	1
您好，请问公司目前的几个投资项目进展如何？特别是大晶信息的光敏剂项目，前期公司一直回答说4季度开始试生产，广大投资者也一直在翘首以盼，现已经入11月，该项目能否如期启动？盼详细回复，谢谢！	您好，公司的一些投资项目进展如何？特别是大正信息光敏剂项目，此前公司回复第四季度开始试产，很多投资者都期待，现在11月，这个项目能如期上线吗？恭候您的详细回复。谢谢。	1
截止到今天收盘股东户数是多少	到今天为止的收盘价，股东人数是多少？	1
请问贵公司确有在持续经营创造效益的供电厂？规模大吗职工几百？月输出电、热产能各约多少？	贵公司有没有真正能够为创造利润而继续运营的电力工厂？规模大吗？数以百计的员工？每月的发电量和发热量是多少？	1
请问截止2021年12月20日收盘，公司的股东户数是多少？非常希望能够及时回复，谢谢。	到2021年12月20日，公司股东户数是多少？我希望你能马上回复。谢谢。	1
公司核心业务影像耗材有什么应用，请介绍一下，谢谢	形象耗材在公司核心业务中的应用是什么？请介绍一下。谢谢。	1
您好，请问截止10月20日收盘，最新的股东人数是多少？望告知一下，谢谢	您好，到10月20日，最新的股东人数是多少？请告诉我。谢谢。	1
公司大股东持股比例并不高，考虑增持股份吗？给股民一点信心吧，股价又创新低了！！！	公司大股东比例不高。你在考虑增收吗？给投资者一点信心，股价又差劲了！	1
公司觉得未来预制菜产业链前景有多大？是否会在预制菜产业链中加大投入生产适配预制菜的产品。谢谢！	该公司如何看待未来预制食品产业链的发展前景？是否加大对预制食品产业链中适合预制蔬菜的产品生产的投入？谢谢。	1
董秘先生，为进一步加速扩大公司业务的区域范围和市场份额，建议公司董事会认真研究是否考虑主动引进具有国资背景的战略投资者，谢谢！	董秘先生建议董事会认真研究是否要积极引入具有国有背景的战略投资者，以进一步加快企业的区域性范围和市场份额的扩大，非常感谢！	1
利托那韦关键中间体生产的产量多少？有无大额订单?	利特纳维亚的重要中间体产量是多少？有大点的吗？	1
到12月31日股东人数是多少？	到12月31日的股东人数是多少？	1
公司研发的碳纳米管属于新材料，建议公司改名“捷邦新材”。	该公司开发的碳纳米管是一种新材料，建议公司更名为“Jaebon新材料”。	1
请问查询特定时点的股东人数，除了提供持股证明和身份证明外，是否还需要其他材料？是否可以通过电子渠道？如果可以请提供电子渠道地址，谢谢。	我想查询具体时间的股东人数，除了提供持股凭证和身份证外，还需要其他材料吗？能用电子频道吗？如果可以的话，请提供电子频道的地址。谢谢。	1
请问董秘，截止7月16日公司股东人数是多少？	请问董秘，到7月16日，该公司股东人数是多少？	1
增材公司目前产能和规划产能是多少？	公司目前的产能和计划的产能是多少？	1
董秘你好，公司现在的产能能跟上订单需求吗？是否满产满销了?公司有没有考虑扩产计划?	请问董秘，公司目前的产能能跟上订单需求吗？它是全面生产还是全面销售？那家公司考虑过扩大生产的计划吗？	1
董秘你好，请问公司相关产品技术对标国外是否可实现国产替代，谢谢？	请问董秘，公司的相关产品和技术在国外可以用国产产品替代吗？谢谢。	1
公司车用高压继电器是否有产品？	这家公司有汽车高压继电器的产品吗？	1
董秘你好，贵公司最近有没有中标新的订单？	董秘，您好。贵公司最近获得过新订单吗？	1
您好！请问截至11月20号，公司股东人数是多少？谢谢	您好！截至11月20日，该公司的股东数量是多少？谢谢你，谢谢	1
目前消息报道，新冠新药获批后默沙东将向105国分享新冠口服药，市场那么大，请问公司该新冠新药的原料药产能能跟得上吗？是不是应该做好扩充产能的准备？谢谢	目前，新冠肺炎新药获批后，玛莎东与105共享新冠肺炎口服药物，市场如此之大，公司新冠肺炎新药原料产量能否跟上？要不要准备扩大产能？谢谢你，谢谢	1
公司现在总的产能是多少？募投项目全部投产后的产能是多少？现有产能以及募投项目之外，公司拟建的产能还有多少？请给投资者准确的数据，辛苦您了，谢谢！	那家公司目前的总产能是多少？资金募集项目全部投产后，产能是多少？除了目前的产能和资金募集项目，该公司计划建设多少产能？请给投资者准确的数据。谢谢。谢谢。	1
请问，我是公司的小股东，如果我想知道11月30号的股东人数，需要什么条件？或是需要我提供什么证明？ 还是说，只有机构投资者才能知道，我们小股东无权知道每个月的股东人数？ 我知道的是，别的公司对机构投资者和小股东是同等对待的，我不知道咱们公司对机构投资者和小股东是一样的，还是不同的待遇？	告辞了。我是这家公司的小股东。如果我想知道11月30日的股东数量，我需要什么样的条件？还是我需要提供什么证据？还是只有机构投资者知道，我们的小股东没有权利知道每个月的股东数量？我所知道的是，其他公司对机构投资者和小股东一视同仁。我不知道我们公司是同样对待机构投资者和小股东还是不一样。	1
电子烟万亿蓝海市场  请问公司的的微型电池是否可以用于电子烟产品	电子烟兆蓝海市场质疑该公司微型电池能否用于电子烟产品	1
尊敬的董秘你好！ 贵公司从发布业绩后近十几天股价出现严重暴跌；业绩同比增长近1300%，可笑的是股价不涨反而暴跌创下近期新低，公司股价是否遭到人为恶意做空还是公司订单、新签项目、与即量产生产线等不及预期？请速自查，公告澄清，给投资者一点点信心！谢谢	尊敬的董秘先生您好。贵公司财报公布后10天股价暴跌，业绩同比增长近1300%。奇怪的是，股价不仅没有上涨，反而暴跌至近期低点。是该公司股价被恶意做空，还是该公司股价卖空、新签的项目、生产线低于预期？请尽快核查自己，澄清公告，给投资者一点信心！谢谢你，谢谢	1
现在股票价格已经跌破净资产,公司启动回购计划了吗?	目前股价已跌破净值，该公司是否启动了回购计划？	1
请问截止目前贵公司股东人数有多少？	到目前为止，你们公司的股东人数是多少？	1
公司的汽车电子产品涵盖了哪些？谢谢	该公司的汽车电子产品涵盖哪些领域？谢谢你，谢谢	1
贵司大晶信息投产从6月份回复下半年投产，到四季度投产，到最新回复还在设备安装，马上2021年就结束了，一拖再拖的项目进度这样的处理方式不是欺骗投资者么？贵司是否应该给与投资者足够的信息公开关注，不要每次等投资者询问再回答，请及时更新贵司新项目进度？谢谢！	贵公司大靖信息从6月投产到下半年投产开始，四季度开始投产，最新的回升还是设备安装方面的情况，立即在2021年结束，项目进度一再推迟，这种处理方式是不是在欺骗投资者？请您的公司给投资者足够的信息，而不是等到投资者提问后再回答，而是及时更新您的新项目进展情况。谢谢。	1
请问截止3月31日公司股东人数是多少？谢谢	截至3月31日，股东人数是多少？谢谢你，谢谢	1
您好，贵公司的产品有应用在农业，农机或者农化产品上吗？	请问您的产品是农用的还是农机的？还是农业用的？	1
董秘，公司在6G方面有技术储备吗？	董秘，公司有6G的技术储备吗？	1
董秘您好！请问截止11月10日目前公司股东户数是多少？融资融券户数又是多少？谢谢	董秘你好。截至11月10日，该公司的股东户数是多少？融资融券的户数是多少？谢谢你，谢谢	1
董秘您好，近期电子烟国标进入“征求意见”阶段，有可能会带动电子烟行业发展，公司有开发电子烟的PCBA板相关产品吗？目前是否有和电子烟厂家有合作？公司是否有计划拓展电子烟产品方面的客户？	你好，董秘。近期，电子烟国家标准进入“征求意见”阶段或将推动电子烟行业发展。该公司是否为电子烟开发PCBA板相关产品？目前正在与电子烟制造商合作吗？该公司是否有计划在电子烟产品方面扩大客户？	1
请问公司领导，贵司7月20日公布减持公告，迄今减持时间已过一半，不用公布减持进展公告吗？	请问公司领导，贵公司7月20日发布，截至目前的减持时间已经过了一半，是否需要公布减持公告的进展情况？	1
尊敬的董秘，您好公司和蓝思科技合作成立湖南蓝思华联精瓷有限公司，思华联精瓷经营范围包括特种陶瓷材料的研制、生产和经营。请问下具体产品有哪些呢？	亲爱的董秘，公司与蓝思科技合作成立湖南澜丝华联精磁有限公司，经营范围包括陶瓷特殊材料的开发、生产和经营。具体有什么产品？	1
装修行业已进入㕵季，公司订单量是否饱满？	装修行业已经进入旺季，公司的订单量满了吗？	1
请问贵公司有考虑江水海品牌升级或者改名成好孩子？	贵公司有没有考虑过升级江水海品牌或改名为好孩子？	1
受俄乌局势和能源等制裁影响，欧洲化工品工厂减产甚至被迫停产，国外化工品价格上涨，公司今年来的产品价格是否有上涨趋势？谢谢	受俄罗斯、乌克兰局势、能源等制裁影响，欧洲化工厂被迫停产，海外化工产品价格上涨。今年该公司产品的价格上涨了吗？谢谢你，谢谢	1
贵公司在光伏项目上的运用是什么产品？	贵公司在太阳能发电项目中的用途是什么？	1
请问公司产品涉及军工方面吗	该公司的产品是否与军工行业有关联？	1
四川二期在建磷酸铁锂项目产能多少万吨每年？预计何时投产？	四川第二期在建磷酸铁锂项目年产能几万吨？打算什么时候投产？	1
贵司终端嵌入式软件有用开源软件研发，根据相关（L）GPL相关协议，如果坚持不闭源也不开放源代码，Qt厂商有权要求召回相关终端设备并在其监督下打上厂商Logo并告知硬件接口如何开源修改等，请问是否有应对措施？另，华为是Qt厂商闭源客户也非常在意供应商开源模块的风险，请问是否知会合作方或者其他海关客户？	您的终端嵌入式软件对于开发开源软件非常有用。根据相关(L)GPL协议，如果声称既不是源代码，也不是源代码，Qt制造商将召回相关终端设备，并在其监督下佩戴制造商Logo，并告诉硬件接口如何修改开源。有什么回复吗？同时，华为是Qt厂商的开源客户，关注供应商开源模块的风险。你会通知合作伙伴或其他海关客户吗？	1
请问元宇宙时代来临，我们公司有没有这方面的技术储备，利用虚拟技术进行产品的设计销售等等？比如虚拟主播销售	随着梅塔巴斯时代的到来，我们公司是否有在这方面的技术储备，使用虚拟技术进行产品设计和销售等？例如虚拟脚轮的销售	1
特别想知道公司的底线在哪里，面对股价连跌多年，毫无行动，准备何时增持股份？	我特别想知道公司的底线在哪里，但是股价已经跌了好几年了，没有动静。你打算什么时候增收？	1
您好，请问公司燃气具及其配套产品是否涉及到出口，如有出口的话主要是什么国家	请问该公司的燃气用具及其配套产品是否与出口有关？如果是这样的话，主要出口国是哪个国家？	1
公司国内的竟争对手有那些上市公司，公司在同类公司中的优势是什么？公司的订单超过20亿，能不能在新增产能的消化下一年内完成？	在该公司的国内竞争对手中，有哪些上市公司？在同一家公司中，对那家公司有什么好处？公司订单量超过20亿，能否在消化新增产能后一年内完成？	1
公司有碘片业务吗	该公司有碘芯片业务吗？	1
新能源汽车替代燃油车已经是明确的历史大势。这是一片广阔的蓝海，还远没有到红海程度。所以我们看到很多企业在抓紧扩产包括和锂电池巨头股权联姻抢时间为将来成为这个行业里的头部企业做准备。公司在锂电铜箔方面只有2万吨产能，也没有后续扩产计划，是否担心到那时在新能源行业被边缘化？	新能源汽车替代燃油汽车是一个明显的历史趋势。那是离红海很远的广阔的蓝色大海。所以很多公司都在争先恐后地扩大生产，我们看到，嫁给锂电池巨头，争取时间将成为未来行业的领先者。该公司在锂铜箔中的产能只有2万吨，没有扩大生产的计划。您是否担心到那时才会在新能源行业被边缘化？	1
董秘您好，看公司财报公司连续五年年收益保持增长态势。今年按二季度来看也是大幅度增长，想问下这种增长态势主要因素是什么？公司后续业绩动力在哪里？公司对自己所处行业发展动力有没有信心？公司主业有没有进一步多元化发展的战略构思？	董秘，您好。请看这家公司的财务报告。该公司收益连续第五年增长。今年第二季度也大幅增长。这一增长趋势的主要因素是什么？公司后续业绩的驱动力在哪里？公司对自己行业的发展动力有信心吗？公司主营业务有没有进一步多样化的战略构想？	1
你好请问截止11月底股东人数是多少	请问到11月底，股东人数是多少？	1
你好：在全面禁抗的政策下，公司中药迎来了机遇，请问现在的泰万菌素和泰乐菌素的产能是多少，未来扩产到多少，出口占比多少？谢谢！	你好：在全面禁止耐药政策下，该公司迎来了中医药机遇。特雷信和特雷信目前的产能是多少，未来会扩大多少，出口的比例是多少？谢谢。	1
尊敬的董秘，您好，据公司资料，在元宇宙领域，公司应用到虚拟现实AR/VR的产品有智能机器人、VR一体机等，同时有着多项虚拟现实AR/VR相关的专利技术。在元宇宙的游戏领域， 子公司深圳宇讯云游科技有限公司主营网络游戏，请问，公司旗下是否有涉及虚拟现实的子公司？	亲爱的董秘，据公司信息，在虚拟航天领域，公司应用于虚拟现实AR/VR的产品包括智能机器人、VR一体机等多项与虚拟现实AR/VR相关的专利技术。在梅塔巴斯的游戏领域，子公司深圳市宇讯云游科技有限公司，主要经营网络游戏。请问该公司是否有与虚拟现实相关的子公司？	1
您好，董秘！公司有对尿素药品方面的产品么？贵司与沙默东的合作已经三年多了，具体合作进展如何？谢谢！	董秘你好。这家公司有尿素药的产品吗？贵公司和夏默顿的合作已经三年多了。具体合作进展如何？谢谢。	1
今年原材料大涨，公司中报说目前是满产状态。请问是否有扩大产能计划？国内有哪些生产基地？是否有海外工厂？对于出口业务有何布局？	今年，原材料价格飙升，该公司报告称，目前已全面开始生产。有扩大产能的计划吗？国内有什么生产基地？有海外工厂吗？出口业务布局如何？	1
董秘你好，请问公司旗下的四川阿尔特公司的三合一电驱动是否已经量产？销量如何？谢谢。	请问董秘，您能告诉我该公司四川阿尔特公司的三合一电动传动装置是否已经量产吗？销售情况如何？谢谢。	1
董秘你好，袁董介绍中国的电信运营商已经在网络规模、业务创新、标准制定等方面居于国际先进行列，公司的主营业务是为中国的电信运营商提供行业领先的OSS软件产品和解决方案，oss软件产品和解决方案是否达到国际领先水平？谢谢！	你好，董秘。袁东表示，中国电信运营商在网络规模、业务创新、标准制定等方面一直跻身国际先进行列。该公司的主要业务是为中国电信运营商提供行业领先的OSS软件产品和解决方案。OSS软件产品和解决方案是否在国际上处于领先地位？谢谢。	1
您好 无人机上要用到大量的减速和控制等微传动部件，公司的产品目前还没有用于无人机的案例，请问公司产品用于无人机目前存在哪些需要攻克的技术难点？公司在为传动产品进入无人机领域有什么规划？ 谢谢！	您好，无人机使用了大量的减速、控制等微致动器。目前，该公司的产品中没有使用无人机的案例。无人机在使用中需要克服哪些技术难点？该公司有哪些变速器产品计划进军无人机领域？谢谢。	1
到1月10日股东人数多少？	到1月10日的股东人数是多少？	1
公司是否有虚拟现实方面的订单？	该公司是否有虚拟现实的订单？	1
公司目前出口美产品是否依然被列入加征关税清单，如若未来这一影响被取消，对公司将产生怎样的影响呢？	目前，该公司对美国的出口是否仍在关税清单上，未来若剔除这一影响，将对该公司产生何种影响？	1
请问，截至2021年11月19日，公司的股东数是多少？谢谢	请问到2021年11月19日，该公司的股东数量是多少？谢谢你，谢谢	1
最近公司新闻消息利好不断，为什么股价跌跌不休，是有股东大规模减持吗？还是有负面消息未公布？	最近，关于该公司的好消息还在继续。为什么股价一直在下降？有没有大规模的股东减支？还是没有什么负面的消息发布？	1
董秘您好:请问贵司尿苷产品12月是否有新签订单或者正在商谈沟通的订单?请给予回复,谢谢!	董秘您好：有没有12月份新签的乌洛科产品订单或洽谈沟通的订单？请给我答复。谢谢。	1
贵公司在芯片和光伏领域是否立项并申请专利，利用相对应领域需要沉降到基材表面的物质去做实验和研究？	贵公司是否在芯片和光伏领域申请专利，并在相应领域使用需要沉积在基板表面的物质进行实验和研究？	1
贵司能否参照688185那样公布最近股东户数？另外扩产工程装修进度怎样了？（上次回复投资者说进入装修了）	你能参考688185公布的近期股东户数吗？此外，扩建项目改造进展如何？(上次我回复投资者进入了这个装修项目。)	1
请问董秘，公司的新冠检测产品有没有在国内申请销售资质？	我是董秘，该公司的新冠肺炎检测产品是否已经在中国申请销售的资质？	1
请问公司是否有氢内燃机的技术储备及研发进程？	公司是否拥有氢内燃机的技术储备和研发流程？	1
尊敬的董秘您好： 请问截至12月10日的股东户数为多少？谢谢	尊敬的董秘您好：到12月10日，股东人数是多少？谢谢你，谢谢	1
请问截止10月10日股东人数？	你能告诉我截至10月10日的股东人数吗？	1
请问公司到12月22日股东人数是多少？	到12月22日，该公司的股东数量是多少？	1
电动汽车、氢燃料汽车、需要用到液压控制系统方面的产品吗？贵公司有提供哪些新能源车供应商？谢谢！	是否需要使用电动汽车、氢燃料汽车和液压控制系统的产品？贵公司提供哪些新能源汽车供应商？谢谢。	1
安九 高铁是否有公司产品？	安久高铁有公司的产品吗？	1
董秘你好，请问贵公司碳化膜应用于储能电池成品有没有最新的进展。	董秘您好，碳化膜在贵公司成品储能电池中的应用有没有最新进展？	1
公司前三季度显示业绩亏损，请问公司全年业绩是不是亏损？公司经营业绩结算，是不是主要在四季度？	该公司在前三个季度出现亏损。该公司的年度业绩亏损吗？公司经营业绩的结算主要是在第四季度吗？	1
董事长你好, 22年在21年的原有产量上，还会有新增产量出现的可能吗？	你好，主席。在21年原产量的基础上，是否有可能在22年的基础上增加产量？	1
董秘你好!问下2020.10.14公告公司增加经营范围里医疗器械项目!请问公司有相关产品上市嘛?研发进度什么程度了?	你好，董秘！下一步要求2020.10.14公司增加医疗器械项目的范围！公司在市场上有相关产品吗？研发进展如何？	1
远大智能高科侧重轨道交通等优势领域市场开发，兼顾航空航天、海洋工程、新能源汽车、家电厨卫等领域，对现有应用领域进行纵向延伸、横向拓展，进一步开发新产品、新技术，创造新的利润增长点。目前进展如何？非公开发行有没有再继续推进？	远大智能高科聚焦轨道交通等优势领域的市场开发，兼顾航空航天、海洋工程、新能源汽车、家用电器、厨房、环卫等领域，对现有应用领域进行纵向和横向延伸。进一步开发新产品新技术，打造新的利润增长点。到目前为止进展如何？非公开发行进一步进行了吗？	1
你好，请问贵公司产品是否可以应用到新冠检测或是新能源、芯片行业中。	您好，您的产品能否应用于新冠肺炎测试或新能源和芯片行业？	1
世界最大的豆粕出口国阿根廷，宣布暂停豆粕出口了，请问公司的水产原料储备是否充足，公司产品近期是否再度涨价？	全球最大豆粕出口国阿根廷宣布暂停豆粕出口。请问该公司是否有足够的水产原料储备，以及最近其产品的价格再次上涨？	1
您好，公司有哪类的产品应用于冬奥会？是否都已经交付？谢谢！	请问该公司有哪些冬奥会专用产品？都到了吗？谢谢。	1
贵司与贵司最大供应商（也是股东之一）之间的关系如何厘清？	如何澄清您的公司与您最大的供应商(也是股东之一)之间的关系？	1
你好，公司与中国航天科技集团公司五院下属轩宇智能公司都是做核工业及特殊环境智能装备系统的，你们2家是何种关系？公司如何在竞争中保持优势地位？谢谢！	您好，公司和中国航天科技集团五院所属轩宇智能公司都在做核工业和特殊环境的智能装备系统。你们两个是什么关系？这家公司是如何在竞争中保持主导地位的？谢谢。	1
公司截止11.30股东人数多少？	截至11时30分，该公司的股东人数是多少？	1
请问公司的钢丝网加强挤出，多股弹簧缠绕技术，亲水涂层，国内是否有同行也具备相同的核心技术工艺呢？	请问该公司的钢丝网加固挤压、多股弹簧缠绕技术、亲水性涂层，国内同行也有相同的核心技术吗？	1
6月15日网上首发路演时，胡伟武还透露，龙芯中科将进军车载芯片市场！请问，贵公司车载芯片的技术专利是否全部自主？	6月15日在线路联袂演出，胡鹏武还透露龙芯中科将进军车载芯片市场！请问你们公司是否拥有车载芯片的所有技术专利？	1
董秘您好，“东数西算”是一个大工程，不仅涵盖了算力需求问题，还提到了绿色节能问题，请问贵司在低耗能节能减排等方面是否有研发和投入，谢谢。	董秘你好。“东算西算”是一项大工程，不仅覆盖数学需求，还提到绿色节能的问题。贵公司在低能耗、节能减排方面有研发和投资吗？谢谢。	1
董秘，你好，请问截止4月29日收盘的股东人数是多少，谢谢！	董秘你好。4月29日收盘的股东人数是多少？谢谢。	1
公司方便器项目是否有新项目，推广是否顺利	公司厕所项目里有新项目吗？推广顺利吗？	1
尊敬的领导你好：请问在公司介入的“智慧物业”和“智慧城管”这两个新行业中，主要竞争对手都有哪些公司？在这介入的两个新赛道中，公司的竞争优势都有哪些？谢谢！	尊敬的领导你好：公司所涉及的知识产权产业和智慧城管这两个新行业中，主要的竞争对手是什么？该公司在这两个新课程中的竞争优势是什么？谢谢。	1
董秘您好！公司今年业务量如何？公司财报上有近四个亿的现金及总计42亿的流动资产，是否会有转型的需要？	董秘你好。公司今年的业务量如何？公司结算现金近4亿，流动资产合计42亿，还需要转换吗？	1
公司获得了一项区块链专利“一种基于区块链的药品批次档案追溯系统”，说明公司拥有区块链技术。请问公司的区块链技术应用于哪些产品？	该公司已获得区块链专利“基于区块链的药品批次文件跟踪系统”，标志着该公司拥有区块链技术。该公司的区块链技术适用于哪些产品？	1
董秘你好:请问公司的主营业务是什么?	你好，董秘：公司的主要业务是什么？	1
请问卡倍亿公司董秘，卡倍亿和对特斯拉供货新能源汽车线缆等产品，在2021年有比2020年增长幅度大吗？	请问财务长10亿，特斯拉供应新能源汽车电缆等产品的情况下，2021年会不会比2020年有更大的增速？	1
董秘您好，强烈建议贵公司通过抖音淘宝等平台开展直播，大幅度通过优质主播宣传贵公司优质的航空胎产品，不然迟早落后时代？不然咋打败外国的品牌！	你好，董秘。贵公司强烈建议通过抖音、淘宝等平台开展直播，通过优质主播大力宣传贵公司优质航空轮胎产品。否则，迟早会落后于时代。否则，怎样才能打败外国品牌！	1
公司大股东持股比例85%，市场流通盘不足，交投不活跃，请问大股东未来三年内是否有减持计划？	公司大股东持股比例为85%，市场流通不足，交易不活跃。大股东未来三年有减息计划吗？	1
董秘您好！山西键合线如果生产资金到位，订单充足，月产值能达多少？谢谢！	董秘你好。山西债券行若产资稳固，订单充足，月产值可达多少？谢谢。	1
尊敬的董秘，您好！ 1. 国家发布体育十四五规划已有半年，请问国内的销量有明显的提升吗？ 2. 越南近期疫情，基本都是每天确诊16000例左右，会否显著增加公司的经营成本？另外越南工厂现在产能是满产状态吗？	尊敬的董秘，你好吗？1、国家提出体育十四五规划已经半年了。国内销售显著增长吗？两个人。越南最近的疫情基本上每天确诊约16000例。会大幅增加公司的运营成本吗？另外，越南工厂的产能现在是全负荷吗？	1
提问，最新股东户数。	问题是，最新的股东数量。	1
董秘您好,公司精良啤酒的进展如何，上海松江精酿啤酒项目现状如何，谢谢!	董秘您好，公司手工艺啤酒进展如何？上海松江克拉夫特啤酒项目现状如何？谢谢。	1
请问到11.10股东人数是多少？谢谢	股东人数不超过11.10人有多少？谢谢你，谢谢	1
公司产品是苹果手机供应商吗？	该公司的产品是iPhone供应商吗？	1
董秘你好，贵公司产品，应用在新能源车的占比是多少？主要是座椅，仪表台？	请问董秘，您的产品在新能源汽车的使用比例是多少？主要是座位，仪表板？	1
您好，请问贵司银包铜量产进度如何了？	请问贵公司的覆银铜生产进展如何？	1
董秘你好，目前公司订单量是否充足？	你好，董梅。公司目前的订单量是否足够？	1
请问公司是否有青春双歧杆菌菌源,是否具备该菌种批量生产能力?	该公司是否有青春型双歧杆菌的来源？你拥有这种菌株的大量生产能力吗？	1
公司有婴幼儿产品吗？销售额和比例占多少？	这家公司有婴儿用品吗？销售量和百分比是多少？	1
越南工厂是否恢复正常生产状态？UGG订单占比多少？秋冬季UGG是否已经完成订单？	越南工厂恢复正常生产了吗？UGG订单的比例是多少？UGG在秋冬完成订单了吗？	1
贵公司最大做强需要稳定下股价，提升一下市值，尽早满足条件纳入深港通，吸引更多专业的投资者和投资机构，提高知名度。 贵公司上市以来从未增持过股价，也没有进行过送股，一直在减持，这样对公司长远发展和公司的稳定发展并不有利。 希望贵公司多做点对投资者有用的事，谢谢	贵公司最大的实力需要稳定股价，增加市值，满足尽快进入深港通的条件，吸引更多专业投资者和投资机构，提高知名度。贵公司上市以来从未涨价，不给股票，一直在减少，不利于公司的长远发展和稳定发展。我希望贵公司能为投资者做一些有益的事情。谢谢。	1
请问公司与辉瑞等国外知名公司在新冠特效药等方面的合作情况？是否是其新冠特效药原材料的主要供应商？	您能告诉我该公司与辉瑞等知名外国公司在新冠肺炎、特效药等方面的合作情况吗？它是新冠肺炎特效药原料的主要供应商吗？	1
用友网络有大量的客户资源，强烈建议公司引进用友网络战略入股，或者与其建立合作关系。	用友网络拥有大量的客户资源，公司强烈建议引入用友网络战略，或与其建立合作关系。	1
您好  请问贵司在化解DDoS攻击方面有什么成果？  谢谢	您好，贵公司在消除DDoS攻击方面取得了哪些成果？谢谢你，谢谢	1
董秘，你好！截止9月30号，股东人数多少？	董秘你好。到9月30日的股东人数是多少？	1
公司生产经营销售电力热能吗？公司在当地规模如何？	该公司是否生产、经营或销售电力和热能？这家公司在当地的规模是多少？	1
公司产品是否有用于军工领域？份额占比多少？	该公司的产品是否用于军事领域？能分成多长时间？	1
请问董秘贵公司能否在新能源和卡脖子领域加大研发投入谢谢	请问董秘贵能否在新能源和Neck领域投入研发？谢谢。	1
公司管理层能否增持公司股份？而不是拿去理财	公司管理层可以增持公司股份吗？而不是用于财务管理。	1
董秘您好，请问新增华东基地3.78万吨冷冻烘焙食品产能、2.31万吨食品原材料的产能包含原来长兴基地的产能吗？还是说是在长兴基地的产能上，额外增加这些产能？	请问董秘，东中国新增的冷冻烘焙食品产能37800吨，食品原料产能2300吨，包括原来长兴基地的产能吗？还是为了提高长兴基地的产能？	1
请问国信证券-农业银行-国信证券鼎信12号员工参与战略配售集合资产管理计划持有的股份是多少股？是首发参与5.97元配售而来的吗？为什么在公司的三季报十大股东看不到该持股股东了？凭空消失了还是已经减持完毕了？该部分股份已经过了限售期了？	请问国信证券-农行中国-国信证券鼎新12号员工持有多少股份参与战略配售集合资金管理计划？5.97元配售是否涉及IPO？为什么前十大股东在公司三期报纸上看不到股东？它是从天上消失的，还是减少了？这部分股票是否已经过了销售限制期？	1
董秘你好，请问公司截至2021年三季度末已经建成的生猪产能是多少？三季报的销售收入中生猪销售收入占比多少？截至三季报公司员工数有多少？能繁母猪有多少头？今年预计出栏目标是否有调整？今年预计出栏多少？公司管理费用率远高于同行业可比公司，是什么原因？	董秘，您好，到2021年三季度末，生猪产能已经完成了多久？三季报中生猪销售收入所占比例是多少？截至第三季度报告，该公司的员工人数是多少？母猪可以繁殖几头？今年的预期目标调整了吗？预计今年会有多少障碍？该公司管理费率远高于该行业的原因是什么？	1
关注到公司今年电子化学品业务增速很快，根据公司π战略发展规划，请结合目前公司实际，电子化学品业务有没有可能发展成为公司第4大业务板块。	关注今年公司电子化学品业务的快速增长，根据公司π战略发展规划，结合公司实际情况，电子化学品业务是否可能发展成为公司第四大业务板块。	1
请问公司是否有向锂电池研发的计划，以便于进一步延伸锂电池控制器产业链，为客户定制和开发更多适宜产品和服务？谢谢。	公司是否拥有锂电池的研发计划？如何进一步延长锂电池控制器的产业链，为客户定制和开发更合适的产品和服务？谢谢。	1
您好,请问公司与三环集团竞争,拥有什么优势?	您好，我们正在与三环集团竞争，该公司有哪些好处？	1
国内、国际都在向新能源产业转型，贵公司作为专注于工业模块的设计和制造的国际领先企业，有没有在制氢模块、锂电模块、核电气体分离装置、智能机器（工业）方面的业务？有没有和大型公司合作和订单（举例说明一下）？	在国内和国际上正在向新的能源产业转型。作为专注于工业模块设计与制造的国际领先公司，您在氢生产模块、锂动力模块、核电气体分离设备、智能机械(行业)业务？贵公司是否与大公司合作订购(例如)？	1
领导您好：请问截止10月20日收盘公司股东户数多少？其中机构持有又是多少家？谢谢！	导师您好：截至10月20日，公司股东人数是多少？其中有多少是由机构拥有的？谢谢。	1
从您的解答中看不出公司与安恒信息有哪些不同。能否具体介绍一下公司电子认证产品信息安全服务和安全集成的具体运用场景和运用实例，谢谢！	从你的回答中，我不知道公司和安恒信息有何不同。您能具体介绍公司电子认证产品在信息安全服务和安全融合中的具体应用场景和实例吗？谢谢。	1
贵公司1-6月预亏,预计三季度纯利润收入如何呢,有退市风险吗?	贵公司从1月到6月都有预亏。第三季度的净利润和收入预计会有多少？有退市的风险吗？	1
公司新厂房在经济开发区，听说明年就可以投产，增加产能饱满的释放，是否属实？	该公司的新工厂位于经济开发区。我听说它将在明年生产。致力于所有产能的释放是真的吗？	1
亲爱的董秘你好，接下来我公司是否有回购股份的计划？	您好，亲爱的董秘，我公司有没有计划下一步回购股票？	1
尊敬的董秘您好，公司已授权或在申请适用于氢能源汽车的专利技术，已方便拓展氢能源汽车领域？	尊敬的董秘，公司已经批准或申请了适用于氢能汽车的专利技术，这是否方便了氢能汽车领域的开展？	1
请问公司：1、半绝缘型碳化硅衬底材料，我国是否受到外国禁运封锁？2、公司产品在该领域的国内市场中占有多少份额？	请问该公司：1、半绝缘碳化硅基板材料，中国是否被国外禁止？2、该公司产品在国内这一领域的市占率是多少？	1
你好，公司是否有开展光伏的项目？有哪些光伏的产品？	请问公司有太阳能发电项目吗？有什么光伏产品？	1
公司与中国核电相比较，优势在哪里？	与中国核电站相比，该公司有哪些优势？	1
董秘你好，请问公司的节能产品，可用于核能供热方面吗？	董秘，您好。该公司的节能产品可以用于核暖气吗？	1
公司的业务有没涉及新冠药或者新冠疫苗	该公司的业务涉及新冠药物还是新冠肺炎疫苗？	1
你好，新导入的产品现成收入了吗	请问新进口产品有现成的收入吗？	1
公司前面说进入了立讯精密，鸿海精密，兵器集团，AFA，科德汽车，中车时代，歌尔，西门子等公司的供应商体系并建立了长期合作关系，请问公司与上述客户有交付实质性的订单吗，公司与上述客户交付的订单是否为整线设备或者制造中的核心设备？还是只是一些低端的辅助设备比如上下料机等？	此前，该公司已进入立信精密、鸿海精密、兵器集团、AFA、代码汽车、中车时代、戈尔、西门子等公司的供应商体系，建立长期合作关系。公司是否向上述客户转交了大量订单？公司向上述客户交付的订单是全线设备吗？还是制造中的核心设备？或者只是着陆器等低端辅助设备？	1
请问贵公司流片情况怎么样？是否开始盛产，有无接到订单	你能告诉我你公司的电影制作情况吗？那个开始盛行了吗？你们收到订单了吗？	1
您好，请问，贵公司截止12月10日股东人数是多少？谢谢！	请问到12月10日，你们公司的股东人数是多少人？谢谢。	1
看到新闻报道公司生产新冠核酸试剂报价78元一人次，和RT-PCR技术相比，价格没有竞争优势，公司该如何克服？募集资金后对于推广RNA诊断又作出了哪些运营调整？看到贵公司网站只有中文版是否目前有海外业务？	看新闻，新冠肺炎公司生产的核酸试剂报价为78元/人，相比RT-PCR技术价格并不具有竞争优势，公司该如何克服？募集资金后，为促进RNA诊断，进行了哪些操作调整？当你看到你的网站上只有一个中文版时，你现在有什么海外业务吗？	1
呼吁召开临时股东大会：讨论回购与增持议案 实施适当市值管理！ 上市公司管理层及董事会面对非正常股价，几万维远股份投资人强烈呼吁实施市值管理拿出具体应对措施，如回购或增持等等，反击无理做空行径维护上市公司及全体持股人利益。 维远股份投资人敬候董秘回复！	临时股东大会召开：讨论并回购实施适当市值管理的建议！面对异常股价，数以万计的威远股份投资者实行市值管理，推出回购或增资等具体措施，强烈呼吁反制不合理做空行为，维护上市公司和全体股东利益。伟源股份投资者在等待董建华的回复！	1
截止1月7日收盘公司股东数是多少？	到1月7日，封闭公司的股东数量是多少？	1
请问公司产品未来会积极扩展到氢能源汽车上应用吗？	该公司的产品未来会积极推广到氢能汽车吗？	1
董秘好，请问截止到12月10号，贵司股东户数是多少？	董秘，截至12月10日，贵公司的股东人数是多少？	1
国内墙布行业每年销售额在多少，行业整体是否进入发展瓶颈期？	国内壁布行业年销售额是多少？整个行业都进入了瓶颈期吗？	1
公司现在磷酸铁锂产能多少？	目前磷酸铁锂的产能是多少？	1
股东户数增加了4倍？	股东家庭的数量增加了四倍吗？	1
请问最新股东人数多少户，谢谢！	能告诉我最新的股东数量吗？谢谢。	1
公司哪个农药产品在行业产量巨大具有特别的竞争优势	在行业巨大的产量中，该公司哪种农药产品具有特殊的竞争优势？	1
请问公司的家用新冠检测产品目前申请进度如何	目前，该公司家用新冠肺炎检测产品的应用进展如何？	1
主要产品有哪些呢	主要产品有哪些？	1
尊敬的董秘，您好请问截止12月14日，公司最新股东数和机构投资者数量各是多少？	尊敬的董秘，到12月14日，公司股东和机构投资者的最新人数是多少？	1
请问，截至十月 08日公司的股东总数是多少？谢谢。	请问到10月8日，该公司股东总数是多少？谢谢。	1
公司第一季度订单如何？运营状况？是否会出现亏损的可能？	该公司第一季度的订单情况如何？运行状态如何？有吃亏的可能性吗？	1
董秘您好！公司产品果麦AR，无论现在果麦AR效果如何，为何董秘都不敢承认公司这个虚里现实的产品，这是为什么呢？	董秘你好。公司的产品果麦AR，不管目前果麦AR的效果如何，为什么书记不能认可公司的虚拟现实产品，为什么会这样？	1
请问最新股东人数是多少？请问贵司可否询问一下二股东平顶山海迅是否有提前终止减持计划？上市两三年了，业绩什么时候能重会增长？	最新的股东人数是多少？请问平顶山海信两位股东是否提前终止了减持计划？它上市已经两三年了，什么时候业绩会再次增长？	1
您好董秘：请问贵公司培训的飞行员都是一些什么群体的客户，培训后都可以驾驶什么样的飞机，是小型私人飞机，还是大型客机或者货机等，公司是否看好飞行员培训业务？	你好，董秘：你在培训哪些客户群飞行员？训练结束后，你驾驶什么样的飞机？小型私人飞机，大型客机还是货机？那家公司对飞行员培训业务乐观吗？	1
请问公司与恒大集团是否有业务合作？	公司是否与恒大集团有业务合作？	1
董秘您好，请问贵公司产品是否用在光伏方面？	董秘，您好，贵公司的产品用于太阳能发电吗？	1
公司是否有自动驾驶方面的产品？谢谢	该公司有自动驾驶产品吗？谢谢你，谢谢	1
亲爱的董秘，啥时候出业绩预告啊。公司最近有没有限电？生产经营还正常吧？订单饱满吗？公司股价低迷很焦心啊	尊敬的董秘，业绩通知书何时签发？最近公司停电了吗？生产经营正常吗？点菜满了吗？该公司股价低迷。我很担心。	1
董秘你好，公司订单充足吗？	董秘，您好。公司的订单量够吗？	1
您好！请问6月20日公司股东人数多少？谢谢！	您好！6月20日，该公司的股东数量是多少？谢谢。	1
董秘你好，贵公司跟宁德时代在碳中和领域有战略合作吗！！！	您好，董秘，贵公司在宁德时代和碳中和领域有战略合作吗！	1
董秘您好！贵公司铝铸件业务亮眼，顺应趋势启动了铝铸汽车零部件扩产计划，有望更好满足市场需求，请问目前公司对这块业务如何规划？有哪些客户？公司是否有成为特斯拉一级供应商的的可能？	董秘你好。贵公司铝铸件业务亮丽，顺应潮流启动铝铸件汽车零部件扩容计划，以期更好地满足市场需求，公司对此业务有何计划？有什么样的客人？该公司是否有可能成为特斯拉的一级供应商？	1
董秘好，有资料显示公司产品有能源机械，请问具体是什么产品？谢谢！	董秘的秘诀是好的。有资料表明，该公司的产品有能源机械，具体有哪些产品？谢谢。	1
您好，请问，贵公司截止3月10日股东人数是多少？谢谢！	请问到3月10日，你们公司的股东人数是多少人？谢谢。	1
董秘你好！请问贵公司产品是否已经运用于军工？谢谢！	你好，董秘！你们的产品在军事工业中使用过吗？谢谢。	1
请问公司截止10月20日股东户数？	请问到10月20日，该公司的股东户数是多少？	1
董秘您好，辛苦了，请问截止8月20日收盘的股东人数，谢谢，祝工作顺利！	董秘，您好。谢谢你努力工作。我想问一下8月20日收盘价的股东人数。谢谢。我希望工作的一切都顺利。	1
请问贵公司最新股东人生是多少	贵公司最新股东的生活是怎样的？	1
问一下贵公司目前鸡苗销量如何？有没有增长	目前贵公司鸡苗销售情况如何？长得长吗？	1
公司今年业绩倍增，得益于新冠疫苗全球海量硬性需求，现在新冠疫苗第三针又要在全国14亿人接种，公司三四季度来自新冠疫苗的订单有多少？	该公司今年的业绩翻了一番，得益于全球对新冠肺炎疫苗的庞大硬需求，目前第三针新冠肺炎疫苗将接种全国14亿人。该公司在第三季度或第四季度从新冠肺炎疫苗中收到了多少订单？	1
您好！请问截至12月20号，公司股东人数是多少？谢谢！	您好！截至12月20日，该公司的股东数量是多少？谢谢。	1
请问截止2021年10月10日的股东账户有多少户，谢谢懂秘。	请问到2021年10月10日有多少个股东账户？谢谢。	1
请问公司的数字营销规模有什么核心的技术含量。以后数字营销的发展战略是怎么样布局	公司数字营销规模的核心技术内容是什么？数字营销未来的发展战略是如何布局的？	1
请问截止12月10日股东人数？	你能告诉我截至12月10日的股东人数吗？	1
董秘你好，请问截止到11月10日公司股东人数为多少？谢谢！	董秘，您好，到11月10日，公司股东人数是多少？谢谢。	1
您好，请问截止11月30日最新股东人数是多少，谢谢。	您好，到11月30日，最新的股东人数是多少？谢谢。	1
公司与北京绿色交易所签战略合作协议涉及的内容请简单介绍一下！谢谢！	请简要介绍公司与北京绿交所签署的战略合作协议内容。谢谢。	1
请问公司截止12月底的最新股东人数是多少？	截至12月底，该公司的最新股东人数是多少？	1
董秘，您好！请问公司磷酸、氢氧化钾设计产能是多少？是否已经达产？谢谢！	董秘你好。磷酸和氢氧化钾的设计生产能力是多少？那个已经达到生产能力了吗？谢谢。	1
请问截止10.20收盘后，公司股东户数有多少？	10.20收盘后，公司股东户数是多少？	1
公司的股价已经跌去了七八成了，还在继续跌，不考虑回购，还在减持。意欲何为啊。上市就为了套现嘛。	该公司股价下跌70%至80%，并继续下跌。不考虑回购，它仍在减少。你想做什么？那个的发售只是为了现金。	1
董秘您好，请问公司几个大股东持续性在股价低位减持的原因是什么	董秘，您好。在股价低迷的情况下，公司几大股东持续减息的原因是什么？	1
请问，截至2021年9月30日，公司的股东数是多少？谢谢	请问到2021年9月30日，该公司的股东数量是多少？谢谢你，谢谢	1
国网与南网订单与往年比较是否有较大提升？	国网、南网的订单量与往年相比有没有大大提高？	1
公司目前和隆基股份合作有那些业务？目前是在光伏上游产业链中，公司产品是否有提价需要？	公司目前与隆基股份合作哪些业务？目前处于光伏产业链上游，公司是否需要上调产品价格？	1
你好，请问公司对第三代半导体应用只有氮化镓充电器吗？如果未来手机降取消充电器接口变成无线充电，公司是否高瞻远瞩已经着手研发无线快充新产品，有没有意愿去研发中端产品来扩大产品的影响力？	请问不只是第三代半导体用的氮化镓充电器吗？如果未来手机放弃取消移动电池接口进入无线充电，公司有没有有远见研发新的无线快充电产品，开发中端产品扩大产品影响力的意志？	1
你好，公司设立元宇动力公司，面向人工智能、虚拟仿真等新一代信息技术超大算力需求，搭建大型算力中心，公司是将其作为未来重要发展战略吗？能讲讲未来的规划吗？	您好，公司将成立远宇电力公司，为人工智能、虚拟仿真等新一代信息技术建设大型计算中心。该公司是否将其视为未来的重要发展战略？你能告诉我你未来的计划吗？	1
董秘您好，请问截止到2022年3月20日股东人数是多少，谢谢。	董秘你好。到2022年3月20日，股东人数是多少？谢谢。	1
请问董秘，最近公司运营如何？	告辞了。董秘，请问公司的经营最近怎么样？	1
您好，公司产品是否适用于自动驾驶系统？	请问我们的产品适用于自动驾驶系统吗？	1
董秘好，公司去年公告拟减持紫光股份的股票，请问现在进展如何呢？	董美浩表示，该公司去年宣布减持紫光股票。现在进展如何？	1
首先感谢你们不辞辛劳的回复我们提出的问题。請問把带有时间和姓名的股票交易软件持仓截图和身份证一并扫描发送至公司邮箱，可以获知 非定期报告相关时点的股东人数吗？盼回复。顺祝你们，身体健康，万事如意, 【比如截至到2022年7月8日贵公司的股东人数是多少？】	首先，谢谢你不厌倦地回答我们的问题。能否通过将有时间、姓名和身份证的股票交易软件截图扫描到公司邮箱，了解不定期报告相关时间的股东人数？我们期待着你的回复。祝你身体健康。希望一切顺利。[例如，截至2022年7月8日，贵公司的股东数量是多少？“”	1
请问，截至2022年1月10日，公司的股东数是多少？谢谢	请问到2022年1月10日，该公司的股东数量是多少？谢谢你，谢谢	1
请问到1.10股东人数是多少	股东人数最多1.10人多少钱？	1
董秘好！贵司上市后应大力宣传自己各种优势与战略，同时应借助资本市场进行横纵向进行资本运作，贵司手握重金，在贵司新赛道的各个方向上找协同效应的公司应该不是难事，望贵司赶紧行动，在自己的战略领域中做大做强。	董秘你好。上市后，贵公司要大力宣传自身的各种优势和战略，同时借助资本市场进行横向和纵向的资本运作。我认为你的公司是有钱人，在你的新课程中找到在各个方向上有协同效应的公司并不难。希望贵公司能尽快行动起来，在自己的战略领域变得强大起来。	1
请问贵公司有子公司曾经有汽车动力锂电池业务,锂电池行情好,可以考虑适时恢复业务。另外微型锂电池向智能穿戴设备供货,是不是有元宇宙概念?	请问贵公司子公司曾经拥有车用动力锂电池业务，且锂电池市场良好，可考虑适时恢复该业务。此外，微锂电池提供智能可穿戴设备，难道不是元巴斯的概念吗？	1
请问贵司半年报预告什么时候发布？贵司称：积极推进供给侧结构性改革，把握实施战略性并购，促进外延式发展。是否已开展相应工作推进？	请问贵公司的半年报什么时候公布？贵公司表示：积极推进供给侧结构性改革，抓好战略性并购实施，推动外延式发展。开展了相应的工作吗？	1
公司这个季业绩出来没。公司订单怎样	该公司本年度的业绩出现了吗？公司的订单怎么样了？	1
董秘，你好，国外猴痘猖獗，已经到达23967例，平均每天增加确诊1千多例，请问公司继上次17批世卫检测猴痘订单后，近期是否接到新订单，请帮忙核实下，另外请问下能借到世卫订单的门槛是不是很高？	你好，董秘、猴痘在国外肆虐，国外猴痘病例已达23967例，日均增加千余例。在收到最近17次WHO猴痘检测订单后，该公司最近收到了什么新订单？请确认一下。此外，世卫组织的借款门槛高吗？	1
请问，截至2022年1月20日，公司的股东数是多少？谢谢	请问到2022年1月20日，该公司的股东数量是多少？谢谢你，谢谢	1
董秘你好！贵司目前以铁矿开采为主业，试问今后有无向其他矿业发展的战略规划？比如锂矿或者金矿等等	你好，董秘！目前，贵公司专注于铁矿石开采。对未来其他矿业的发展有什么战略性规划吗？锂矿，金矿等等。	1
请问公司的机器视觉业务相比海康威视子公司海康机器人的机器视觉业务以及大华股份子公司华睿的机器视觉业务有何优势和劣势？	与海康威视旗下的海康机器人和大华旗下的华睿相比，该公司的机器视觉业务有哪些优势和劣势？	1
你好董秘，公司在电子化学品领域，电子材料用高级酚醛树脂打破多项国外垄断，实现平板显示、芯片光刻胶用电子树脂国产化，可助力“中国芯”研发制造。请问在光刻胶的其他细分领域贵公司是否有持续投入研发，打破垄断？谢谢	你好董秘，在电子化工领域，公司以先进的酚醛树脂打破国外诸多垄断，实现平板显示、芯片型光致抗蚀剂用电子树脂国产化，可有助于“中国芯”的研发制造。贵公司是否继续投入研发，打破光致抗蚀剂在其他细分领域的垄断？谢谢你，谢谢	1
预制菜有用到公司的产品吗	准备好的菜对公司的产品有用吗？	1
公司截止11月1日股东数？前十大都是自然人还是有机构或者基金看好公司而买进？	截至11月1日，公司的股东数量是多少？排名前10位的大多是自然人，还是机构或基金看着公司买入？	1
请问：截至2021年11月17日，公司的股东人数为多少？谢谢！	打扰一下：截至2021年11月17日，该公司股东数量是多少？谢谢。	1
请问一下，截止12月10日最新的股东人数是多少？望告知一下，万分感谢	告辞了。到12月10日，最新的股东人数是多少？请告诉我。非常感谢。	1
公司出口产品美元结算占比多少？	该公司出口产品的美元结算比例是多少？	1
公司有氢能源项目研发及相关技术储备吗？	公司是否有氢能项目的研发和相关技术储备？	1
公司发行股价是怎么制定的？为何连续半个月低于发行价？有回购计划吗？	该公司的股价是如何发行的？为什么发行价持续不到半个月？有回购计划吗？	1
董秘您好，网传贵司成都子公司引入战略投资方的问题，大基金二期有意向布局进来，请董秘核实真伪，谢谢。	您好，董秘，您的成都子公司引入战略投资者的问题正在网上流传。该大型基金的第二个阶段计划将进入。请确认董秘的真实性。谢谢。	1
董秘您好！请教公司到今天10月20日股东户数是多少？谢谢！	董秘你好。到今天10月20日，该公司的股东数量是多少？谢谢。	1
董秘您好，请问截至目前公司的股东数量为多少，谢谢	董秘你好。到目前为止，该公司的股东数量是多少？谢谢。	1
请问董秘：截止2021年11月22日，公司股东人数是多少？	董秘：截至2021年11月22日，公司股东人数是多少？	1
董秘,你好,首先感谢你万忙之中回答投资者的问题,本人坚定看好公司的发展,既然公司已经向风电和光伏的领域发展,诚心建议公司改名,圣元新能或圣元能源,更能体现贵公司的业务。谢谢!	董秘您好，首先感谢您在百忙之中回答投资者的问题。我对公司的发展持坚定的乐观态度。既然公司已经发展到风电和太阳能发电领域，我真诚地建议公司改为盛源新能源或盛源能源。它可以更好地反映贵公司的业务。谢谢。	1
请问董秘，与华安县政府合约进展到哪一步了？	请问董秘，与华安县政府签约进展如何？	1
请问现在的股东户数是多少？由于原材料价格上涨，对公司影响如何？是否考虑适当提高产品价格？	目前股东家庭的数量是多少？原材料价格的上涨将对公司产生怎样的影响？你有没有考虑过适当提高产品的价格？	1
请问公司在开展海水提铀技术的研究吗?有关海水提铀关键技术——吸附材料方面公司有没有技术积累?	该公司有研究从海水中提取铀的技术吗？该公司在海水吸附剂提铀的关键技术上有技术积累吗？	1
公司超高价发行 募集大额现金 又没有好的投资标的 是否可以回购股份或者大比例送配？	该公司能以超高价格发行和筹集大量现金，没有良好的投资目的地吗？它能回购股票，还是大比例赠送？	1
尊敬的董秘，你好。请问目前公司订单情况如何？公司新产能的产能释放情况如何？谢谢。	尊敬的董秘，你好。该公司的订单现在是什么状态？该公司新产能释放情况如何？谢谢。	1
董秘你好，请问截止到2022年1月22日，公司股东人数是多少	董秘你好。截至2022年1月22日，该公司的股东数量是多少？	1
请问董秘：截止6.18号的股东人数和机构数各是多少？	董秘：目前到6.18为止，股东和机构的数目是多少？	1
请问公司有氢能源方面的产品吗？	这家公司有氢能产品吗？	1
请问董秘，截止2021年11月30日，公司股东人数是多少？	请问董秘，到2021年11月30日，公司股东人数是多少？	1
请问，截至2021年11月10日，公司的股东数是多少？谢谢	请问到2021年11月10日，该公司的股东数量是多少？谢谢你，谢谢	1
董秘您好，贵公司有无准备扩产或加速扩产新能源及新能源汽车方面的产品出货量	董秘，您好。贵公司是否准备好扩大或加快新能源和新能源汽车的生产？	1
你好，截止12.月24日公司股东人数是多少？谢谢！	您好，截至12日，公司4月24日的股东人数是多少？谢谢。	1
您好，请问贵公司主要向辉瑞公司提供哪些产品？占比如何？	您好，主要为辉瑞公司提供哪些产品？百分率是多少？	1
请问公司的产品能否应用于镍氢电池的电解液？	该公司的产品能否应用于MH-Ni电池的电解液？	1
请问公司是否有PET铜箔相关技术储备	公司是否拥有与PET铜箔相关的技术储备？	1
请问，截至2021年12月31日，公司的股东数是多少？谢谢	请问到2021年12月31日，该公司的股东数量是多少？谢谢你，谢谢	1
董秘你好，请问截止2021年底，贵公司最新股东人数是多少？谢谢	董秘你好。到2021年底，贵公司的最新股东人数是多少？谢谢你，谢谢	1
董秘好！请问一吨氯化亚砜的产能需要多少液氯与液硫？	董秘你好。1吨亚硫酰氯的产能需要多少液氯和液硫？	1
请问公司有短视频业务吗？未来会加大和抖音快手合作吗？	这家公司有短视频服务吗？未来是不是要加强与抖音快手的合作？	1
公司是否属于智能制造和高端装备行业的标杆企业，在人工智能方面有布局吗，产品的寿命一般多久，市场占有率有多高，竞争对手和公司之间差距在哪里	公司是否属于智能制造和高端装备行业的标杆企业？在人工智能领域有布局吗？产品的寿命是多长？市场占有率是多少？竞争对手和公司的差距是什么？	1
董秘你好，公司有扩产规划，和拓展其他业务的规划吗？	你好，董秘，公司有没有计划扩大生产和其他业务？	1
您好，董秘，小家电方面是公司发展的重点吗？公司进有没有为一些潮流品牌代工净化器，键盘，小风扇？洛斐是等品牌是公司的客户吗？	董秘您好，小家电是公司发展的重点吗？该公司是否为几个时尚品牌生产空气净化器、键盘和风扇？罗飞是在等品牌成为公司客户吗？	1
请问贵公司有计划开发新业务吗	贵公司有发展新业务的计划吗？	1
贵公司VR产品给那些公司配套？	哪个公司配备了你们的VR产品？	1
尊敬的董秘您好，近日，住房和城乡建设部印发《“十四五”建筑节能与绿色建筑发展规划》明确，到2025年，城镇新建建筑全面建成绿色建筑，建筑能源利用效率稳步提升，建筑用能，请问贵司的植物照明产品和技术在设施农业和植物工厂应用中比传统LED更加绿色节能环保和优势？	亲爱的董秘，近日，住房和城乡建设部印发“建筑节能与绿色建筑发展第十四个五年规划”。明确到2025年，要全面建成城市新建筑，切实提高建筑能效，实现建筑用能。您的植物照明产品和技术在设施农业和植物工厂应用上比传统LED更绿色、节能、环保和优势。	1
储能市场目前看相当一段时间会保持良好发展态势，公司会立足目前基础，未来会立足公司现有的技术，涉足储能产品的研发和生产力度吗？	目前，储能市场在相当一段时间内保持了良好的发展态势，公司会在现有的基础上，未来基于公司现有的技术，参与储能产品的研发和生产吗？	1
贵公司的产品优势在哪？ 订单是否饱满？ 贵公司的软件开发是否能对外产生效益还是仅仅作为配套显示使用	贵公司产品的优势是什么？点菜满了吗？贵公司的软件开发是否可以产生外部利益，或者只是作为展示辅助使用？	1
公司医疗产品领域有没有疫苗注射器产品？有没有疫苗医药瓶产品？谢谢	该公司在医疗产品领域有疫苗注射器产品吗？有疫苗的瓶子吗？谢谢你，谢谢	1
董秘您好,请问新产能投放后的产能利用率达到多少?是否满产?	董秘您好，新产能投产后产能利用率是多少？不是全面开工了吗？	1
董秘您好，双十一即将来临，叠加寒潮来袭，请问公司近期是否满产？销量如何？考虑到物料成本上升，公司产品是否有提价或是否考虑提价？	董秘你好。随着双十一的到来，寒潮叠加涌来。那家公司在不久的将来全面投产吗？销售情况如何？鉴于材料成本不断上升，该公司究竟是提高了产品价格，还是考虑上调价格？	1
请问公司的主业是什么？有没有光电产品？公司的名字符合主业发展吗？有没有为了突出主业更名的计划，公司有没有回报投资者的高送转计划？还有最近公司成立的私募基金有没有增持公司股份的计划？谢谢。麻烦公司尽快回复各个问题？	公司的主要业务是什么？有光电产品吗？公司名称是否与主营业务的发展一致？有没有计划强调主业务的名称更改？公司是否有高额转移计划来回报投资者？该公司最近成立的私募股权基金是否有计划增持该公司的股份？谢谢。你能尽快回答所有的问题吗？	1
请问公司有生产睡袋和帐篷产品吗？产销量怎么样?	这家公司生产睡袋和帐篷吗？生产和销售情况如何？	1
管理层好，请问公司的高牌号取向硅钢、高牌号无取向硅钢产品和宝钢股份相比，有什么优势？如何应对未来的竞争？	管理好了。公司高级定向硅钢、高级无定向硅钢产品和宝钢股份有哪些优势？如何应对未来的竞争？	1
看公司上个月回复说公司网站正在改版，请问公司新版网站什么时候能够上线呢？	看，该公司上个月回复称，公司的网站已被修改。该公司网站的新版何时上市？	1
董秘你好，新能源行业的新赛道，贵公司在镍金属行业的业务有哪些，在镍金属行业贵公司有哪些业务	您好，董秘，新能源行业新课程，在镍金属行业做什么？你在镍金属行业的业务是什么？	1
董秘，今年中期财报显示向员工支付佣金及花红为27.39万元／人，全年则达54.78万元／人，请问公司发电量且利润增长率均大大低于中核集团，这好像与公司采取具有竞争力的薪金政策相矛盾，如何理解？有何具体措施治理这种懒人效应或者大锅饭式出勤不出力的过高管理成本情况。谢谢。	董秘指出，今年中期财务报告显示，支付给员工的手续费和奖金为每人273900元，全年人均547800元。请问该公司的发电量和利润增长率远低于中国核工业公司吗？这看起来与公司的竞争性工资政策相矛盾，你怎么理解呢？有没有懒惰效应或非生产性工作管理成本过高的具体措施？谢谢。	1
到今天十月二十一日，股东户数	截至今日10月21日股东户数	1
请问贵公司旗下产品有没有在新能源车方面的应用？	贵公司的产品应用于新能源汽车吗？	1
董秘您好、最近想买金条、请问贵公司黄金金条业务是否为京东公司提供金条定制产品？看到京东商城上京东金条销量很好、上面标注着中国黄金定制，是否属实？该黄金金条是投资金条吗？将来购买是否支持回购业务？回购业务是找京东商城还是找中国黄金呢？谢谢	董秘，您好。我最近想买金条。您的金条业务是否为京东提供定制金条？看到京东商城京东金条销量好，显示为中国定制的金条，是真的吗？这根金条是投资金条吗？未来的购买是否支持回购业务？回购业务是找京东商城吗？还是找中国的钱？谢谢你，谢谢	1
尊敬的公司领导，公司2016年中标了大功率舰船用发动机传动链条的国家强基项目，能否说明一下，目前该项目的进度如何，有产品吗？谢谢。	尊敬的公司领导，公司于2016年荣获国家大功率船用发动机传动链强基地项目。你能解释一下这个项目的进展吗？有什么产品吗？谢谢。	1
问贵公司作为国内规模较大的电源充电器生产厂商，请问是否有针对新能源汽车充电桩，光伏发电方面的适配器产品	作为国内大型的电力充电器制造商，有没有新能源汽车充电桩和光伏发电适配器？	1
董秘您好，贵司控股子公司浙能嵊泗海上风电开发有限公司拟投资建设的浙能嵊泗1、3、4号海上风电项目进展如何？贵司控股子公司浙能临海海上风力发电有限公司(暂定名)拟投资建设的临海市浙能台州1#海上风电进展如何？	你好，董秘。贵公司控股子公司浙江能盛思海上风电开发有限公司拟投资的1号、3号、4号海上风电项目进展如何？您的控股子公司浙江能临海海上风电有限公司(暂称)拟在临海、台州投资建设海上风电。海上风力发电进展如何？	1
你好董秘！公司有生产数字货币领域方面的产品吗？谢谢！	董秘你好。那家公司生产数字货币领域的产品吗？谢谢。	1
请问截止到2021年7月10日 股东人数是多少 谢谢	到2021年7月10日，股东人数是多少？谢谢。	1
请问公司产品支持华为操作系统吗？	该公司的产品是否支持华为操作系统？	1
董秘你好，公司处于上中下产业链哪环呢，竞争对手和核心的优势几何？	请问董秘，公司在上、中、下游产业链中是什么样的环，竞争对手和核心有哪些优势？	1
您好，华科资产持续的股票减持明显影响了股价，请问公司实控人阎总希望华科资产将持股比例控制在一个什么区间，才觉得是一个很好的股权关系呢？	你好，华科资产的连续减持明显影响了股价。公司实控人严先生，华科的资产想把持股比例控制在多大范围，感觉有好的股权关系？	1
董秘好：按照2021年8月13号礼来的减持公告，减持期应截止于今年3月5日，为什么公司没有发布相关公告？	董美娟：根据礼来公司2021年8月13日的公告，减持期限将于今年3月5日结束。为什么该公司没有发布相关公告？	1
请问公司有军工企业的订单，或是，未来有和军工企业合作的方向？安徽成飞集成瑞鹄是否有军工产品？	该公司是否有军工企业订单，还是未来与军工企业的合作方向？安徽成飞整合瑞湖有军品吗？	1
董秘你好，金龙鱼近年加大投资的各种生产基地和产能，在未来将成为金龙鱼走出去战略的强大支撑，在满足国内粮油食品消费升级的需求后，也会为一带一路沿线国家提供优质食材。	你好，董秘。金龙鱼近年来加大投资各生产基地和产能，将成为金龙鱼未来出行战略的有力支撑。满足国内粮油食品消费升级需求后，将为一带一路沿线国家提供优质食材。	1
请问到8.10股东人数是多少？	股东人数在8.10人以下的人有多少？	1
贵公司宣称业绩好，现在行业也在风口上，而股价却跌破发行价，难道公司有利空吗？染料市场大幅涨价，公司产品却不涨，难道有利益输送吗？	你们公司声称业绩不错，现在行业也很流行，但股价已经跌破发行价，公司可以吗？染料市场价格大幅上涨，但该公司的产品并未上涨。有利润转移吗？	1
请问懂密截止2021年12月20日公司股东人数为多少谢谢	截至2021年12月20日，该公司的股东数量是多少？谢谢。	1
请问截止2021年8月31日 股东人数是多少 谢谢	到2021年8月31日，股东人数是多少？谢谢。	1
董秘您好，请问公司给元宇宙提供产品的销量怎么样，前景如何，谢谢	你好，董秘。该公司向远大航天提供的产品销售情况和前景如何？谢谢。	1
请问公司在手订单仅4亿元，上市以来却已经多次向市场伸手募集资金，资金的用途是否合理？是否经得起监管部门的检查？投资者集体投诉的事件，公司如何处理？解释？	请问手工订购的公司只有4亿元，既然上市多次向市场伸手募集资金，资金使用是否合理？能经得起监管部门的检查吗？公司如何处理投资者集体投诉案件？你能解释一下吗？	1
您好，公司产品是否已应用于汽车智能制造业？传统汽车厂商和造车新势力有那些典型终端客户？在智能制造方面公司有清晰的发展路径么？谢谢	您好，该公司的产品是否应用于汽车智能制造行业？传统汽车制造商和新汽车制造商的典型终端客户是什么？该公司在智能制造方面是否有明确的发展路径？谢谢你，谢谢	1
新能源车数量增长预期很大，公司电路板产能又充足，公司有提价能力吗	预计新能源汽车数量将大幅增长，公司拥有足够的电路板产能。这家公司有能力涨价吗？	1
你好！贵公司有产品供应三星吗？或者说有开始在洽谈吗？	你好！贵公司有面向三星的产品吗？还是你们已经开始谈判了？	1
请问贵公司截止到2021年8月31日，股东数量是多少	截至2021年8月31日，贵公司的股东数量是多少？	1
您好，猴痘病毒近期在全球肆虐，患者后期身体会出现大面积化脓、感染等症状。请问贵公司康替唑胺等产品，在应对化脓性链球菌，皮肤和软组织感染等方面能不能有效果呢？	你好，萨尔波病毒最近在世界上肆虐，患者后期会出现广泛的化脓、感染等症状。贵公司的产品，如康替唑胺，能否有效治疗化脓性链球菌、皮肤和软组织感染？	1
面对公司股价暴跌，贵公司高层是否有意增持公司股票，以彰显你们对于公司有信心？	面对公司股价暴跌，贵公司高管是否有意增持公司股票，以显示对公司的信心？	1
董秘，您好，贵公司股价持续低迷，已经从最高点腰斩，好股价，好产品，才能产销两旺，上市快两年了，渠道扩张现在情况怎么样	你好，董秘，你公司的股价一直低迷，从最高点减半。只有好的股价和好的产品，我们才能拥有繁荣的生产和销售。我们已经上市近两年了。渠道部署的现状是什么？	1
董秘您好！请问目前公司流通股股东户数多少？机构多少家持股数量又是多少？谢谢！	董秘你好。请问目前该公司流通股的股东人数是多少？有多少机构持有股票，有多少股票？谢谢。	1
公司股票从上市后一直在跌，公司可以考虑回购一下公司股票，	自上市以来，该公司股价一直在下跌，因此该公司可以考虑回购公司股票。	1
董秘您好，华为、小米是公司的客户之一，公司未来会否与华为、小米汽车触碰显示屏上合作？	董秘，您好。华为和小米是该公司的客户之一。该公司未来会与华为和小米在触摸屏上合作吗？	1
请问公司订单量充足了，印刷电路版普遍业绩优良，公司为何一上市就业绩下滑，有什么针对措施吗	告辞了。该公司订单量充足，印刷电路版一般有不错的表现。为什么公司一上市业绩就会下降？有针对那个的措施吗？	1
请问公司在环保领域的订单，今年有所增长吗？	今年该公司在环保领域的订单会增加吗？	1
请问，截至2022年3月10日，公司的股东数是多少？谢谢	请问到2022年3月10日，该公司的股东数量是多少？谢谢你，谢谢	1
您好！请问截至1月20号，公司股东人数是多少？谢谢！	您好！截至1月20日，该公司的股东数量是多少？谢谢。	1
董秘您好，请问贵司是否拥有铈铁硼相关产品？谢谢。	董秘先生，您好，贵公司有没有铈、铁、硼相关的产品？谢谢。	1
加快获取储能订单，在这方面近期没有什么作为啊	加快收购储能订单。在不久的将来，我在这方面什么也没做。	1
请问公司目前的股东人数多少	那家公司现在的股东数是多少？	1
公司的产品可否用于航空航天以及军工方面？	该公司的产品可以用于航空航天和军事产业吗？	1
董秘您好!请问公司截至目前的最大产能是多少?2020年及2021年1至9月的产能利用率分别达到多少?谢谢!	董秘你好。到目前为止，该公司的最大产能是多少？2020年和2021年1-9月产能利用率分别是多少？谢谢。	1
董秘，你好，请问公司有一纳电专利进入知识产权局的公示期了，其名称是什么，另外请问纳电相关专利是以哪个主体申请的以便查询，谢谢	董秘，您好，该公司有一个南电专利进入知识产权局公示期。这个叫什么名字？另外，我想问一下专利申请有哪些课题。谢谢。	1
尊敬的董秘，你好！请问截止到3月20号公司的股东人数是多少户？谢谢	尊敬的董秘先生您好。截至3月20日，该公司的股东数量是多少？谢谢你，谢谢	1
您好！公司有股价大幅下跌，请问公司目前在手订单金额是多少？	你好！该公司股价大幅下挫。手头的订单量是多少？	1
截至本招股说明书签署日，公司已签署的新冠疫苗用胶塞合同累计金额超过9 亿元，累计订单签订的胶塞数量超过 49 亿只。公司新冠疫苗相关用胶塞客户包括北京科兴、康希诺生物、智飞生物、康泰生物、武汉生物制品等国内所有新冠疫苗厂商，也是辉瑞医药的供应商，情况是否属实？	截至本次招股书签署日，公司累计签约新冠肺炎疫苗栓签约金额超9亿元，累计订单签约胶栓超49亿个。该公司新冠肺炎疫苗相关橡胶栓客户包括北京科兴、康西诺生物、智飞生物、康泰生物、武汉生物制品等国内新冠肺炎疫苗制造商，也是辉瑞制药的供应商。这是真的吗？	1
尊敬的董秘，你好，一直持有贵公司股票，也非常看好公司的发展，可是一个月来，股票却一直下跌，请问此原因是不是公司发展滞后，收入不及预期有关，另外，现在雨季，是不是更有利于公司业务，谢谢。	亲爱的董秘，您好，我一直持有贵公司的股票，我非常期待公司的发展，但在过去的一个月里，股票一直在下跌。对不起，这是因为公司发展迟缓，没有期望收入。此外，现在是雨季，因此对公司业务更有利。谢谢。	1
请问公司在20年共生产了多少eva光伏料？设计产能是多少？产品均价是多少？	过去20年来，该公司生产了多少Eva太阳能发电材料？设计能力是多少？产品的平均价格是多少？	1
请问美国迈图、日本信越、埃肯有机硅都是公司的客户吗？	请问美国的迈顿、日本的信越、艾肯硅胶都是该公司的客户吗？	1
1.如何解决存货周期长2.电商平台销量如何3.直播有何进展4.有请代言人打算？5.有战略合作合作伙伴吗？	1.如何解决库存周期长的问题2.电商平台销量如何3.直播怎么样？4.你想要代言人吗？5.有战略合作伙伴吗？	1
董秘您好，贵司上市即破发，让中签的投资者损失严重，请问21年年报是否有发红送股或股东增持等来维护投资者，谢谢	董秘，你好，你的公司一上市就破产。这会给当选投资者造成严重损失。请问这份21年年报有否派发股息或股东增持股份，以保障投资者？谢谢。	1
请问截至7月9日，公司最新股东人数是多少，谢谢	截至7月9日，该公司的最新股东数量是多少？谢谢。	1
请问董秘：截止到7.10号的股东人数和机构数各是多少？	董秘：目前到7.10，公司股东和机构的数量是多少？	1
请提供邮箱，便于发送相关证明材料，以查阅股东人数。目前疫情严重，现现场查阅不现实，请为远程查询提供便利，而不是只提供座机电话。谢谢！	请提供电子邮件地址，以方便发送相关证明文件并确认股东数量。当前疫情严峻，目前现场看病不现实。请方便远程查询，而不是只提供固定电话。谢谢。	1
据记者报道，“在已经公布的信息中，圣窖酒业并未提及酒城酒业的存在，那么圣窖酒业、酒城酒业和王祖烧坊之间到底是什么样的关系，圣窖酒业在茅台镇的工厂，究竟有多少酱酒产能和储酒能力是属于圣窖酒业？哪些属于酒城酒业和王祖烧坊？”，敬请公司领导给予说明回答！	据记者报道，“在已经发布的信息中，圣窖酒业没有提到酒城酒业的存在，但圣藏酒业、酒城酒业和王祖烧酒作坊之间有什么关系？圣藏酒业有多少酱酒生产能力和储存量？哪个属于酒城酒业和王祖烧房？“请得到公司上司的回复和回复！	1
截止1108，股东总数是多少	到1108，股东总数是多少？	1
2021 年公司锻件总产量超 10 万吨。请问均价多少一吨？	2021年，锻件总产量超过100000吨。每吨的平均价格是多少？	1
公司有自己的药店吗	这家公司有自己的药店吗？	1
请问贵公司在温州的工厂，面粉车间什么时候投产？谢谢	你在温州的工厂和面粉厂什么时候投产？谢谢你，谢谢	1
您好领导：截止11月30号收盘股东人数多少？其中机构持有又是多少家？谢谢！	领导大家好：截至11月30日，被关闭的股东人数是多少？其中有多少是由机构拥有的？谢谢。	1
公司电力电气节能相关领域的产品有哪些？	公司在电力和电力节能相关领域有哪些产品？	1
董秘你好，贵公司在北上广深发达城市有业务合作吗？？？	请问董秘，贵公司在北京、上海、广州、深圳等发达城市有业务合作吗？	1
目前贵公司股票持续下跌，大量PE解禁或减持，他们是否对公司经营不看好？	目前贵公司的股票持续下跌，大量PE禁止或减少销售，他们是不是不看好公司的经营呢？	1
我先问一下,咱们公司的业务,是否跟白酒行业里的华致酒行,相似,就是所有器械的总代理。	首先，我问一下我们公司的业务是否类似于白酒行业的华芝酒业公司，也就是所有设备的总代理。	1
近期股东频繁减持，股价节节跌，请问董秘公司有什么对策来稳定股东的信心，来稳定股价	近日，股东频繁减持，股价节节下跌。东美公司有哪些稳定股东信心、稳定股价的措施？	1
公司是否有参与生态保护修复项目投资、设计、修复、管护等？是否有围绕生态保护修复开展生态产品开发、产业发展、科技创新、技术服务等业务？	公司是否参与生态保护修复项目的投资、设计、修复、管理？围绕生态保护修复有什么业务吗？比如生态产品开发、产业发展、科技创新、技术服务等？	1
高管减持，破发后股价持续大跌，请问公司是否有重大事情没有公布或预告，三季度财报是否有预减50%，或亏损，请回答，谢谢！	高管减产，休市后股价仍持续暴跌。你能告诉我有什么重大的事情没有公布或者没有公布吗？三季度结算价是减半，还是亏损，请回答。谢谢。	1
尊敬的公司董秘，您好，公司作为生命科学研发服务商，是国内专业的、全面的抗体供应商，在行业内已树立了“优宁维-抗体专家”的品牌形象，请问在新冠疫苗以及新冠相关产品领域，公司是否有提供研究阶段所需的科研试剂及相关耗材？新冠病毒是人类共同的敌人，建议公司加大科研力度，为抗击新冠肺炎疫情作出贡献！	尊敬的董秘，您好，公司作为生命科学研发服务商，在中国是一家专业、全面的抗体供应商，在行业内树立了“优宁卫-抗体专家”的品牌形象。在新冠肺炎疫苗及新冠肺炎相关产品领域，公司是否为研究阶段提供科研试剂及相关耗材？新型冠状病毒是人类的公敌。该公司建议加强科研，为抗击新冠肺炎疫情贡献力量。	1
请问截止2021年11月30日收盘，公司的股东户数是多少？非常感谢能够及时回复，谢谢。	到2021年11月30日，公司股东户数是多少？谢谢你及时的回复。谢谢。	1
董秘，您好，请问截止11月30日收盘，公司股东人数是多少？谢谢！	董秘，您好，截至11月30日公司股东人数是多少？谢谢。	1
你好。董秘。受印度疫情影响，印度生产电子设备的都停工了，贵公司海外工厂情况如何？近期公司有没有计划对产品提价？	你好。我是董秘。受印度疫情的影响，印度的电子设备生产已经停止生产。你们海外工厂的情况如何？那个公司有没有计划在不久的将来提高那个产品的价格？	1
董秘你好，请问公司产品是否可以用于基建？如水利，交通等等。	董秘，请问公司的产品可以用于基础设施建设吗？比如水利、交通等。	1
本人非常看好贵公司，双立人目前年销售全球10-15亿美金，而贵公司去年销售才五亿人民币，相差20倍，作为中国老字号应该差异化竞争，推出符合张小泉悠久历史皇室血脉的高端产品，这一点应该向片仔癀，茅台学习。我建议贵公司可以联手爱马仕或者lvmh集团推出高端联名居家厨房产品系列打造中标顶流厨房用具品牌	我非常看好贵公司。双利人目前在全球销售100-15亿美元，而贵公司去年仅销售5亿元人民币，相差20倍。作为中华老字号，我们应该进行差异化竞争，推出符合张小泉悠久历史皇室血统的高端产品。我们要向片仔和茅台学习。我建议您的公司与爱马仕和LVMH集团联手推出一系列高端联合品牌家居厨房，打造顶级厨房用具品牌。	1
董秘您好，请问公司截至9月30日股东户数是多少？谢谢！	董秘，您好，到9月30日，公司股东户数是多少？谢谢。	1
董秘你好，请问欧拉好猫具体上市时间	董秘你好。能告诉我欧拉的猫什么时候上市吗？	1
请问12月20日股东人数？	请问12月20日的股东人数是多少？	1
请问公司产品是否有直接或者间接供货特斯拉？谢谢	请问该公司的产品是直接还是间接供应给特斯拉？谢谢你，谢谢	1
尊敬的董秘你好，公司申请的红外辐射制冷光学涂料和光学膜专利，可否讲解一下该专利产品的应用领域和市场前景吗？很期待公司的科技创新能形成推动公司发展和股价上涨的动力	亲爱的董秘，您能说明一下公司申请的红外冷却光学涂层和光学薄膜专利，该专利产品的应用领域和市场前景吗？预计公司科技创新将成为推动公司发展和股价上涨的原动力。	1
请问，截至十二月 10日公司的股东总数是多少？谢谢	请问到12月10日，该公司股东总数是多少？谢谢你，谢谢	1
贵公司生产的产品属于新基建领域吗？	贵公司生产的产品属于新的基础设施领域吗？	1
您好，请问截止8月15日，公司的猴痘试剂检测盒共接到了多少批次的订单(国外世卫组织和国内科研单位）？	您好，截至8月15日，该公司的猴痘检测套件已接到多少批订单(国外世界卫生组织和国内科研机构)。	1
董秘您好，想问下公司产能利用率多少，是否满负荷生产？ 请问贵公司是否和开山股份一样有生产制氧用空气压缩机？公司在碳中和，碳捕捉方面有什么产品或者研发？	董秘你好。我想问一下，该公司的产能利用率是多少，全生产？你们公司生产制氧用空气压缩机和开山一样吗？该公司在碳中和碳捕获方面进行了哪些产品和研发？	1
请问截止到1月10日的股东总数？	你能告诉我截至1月10日的股东总数吗？	1
董大人，请问每年对经销商有没有强制要求下多少定单？	董秘，你们每年都有经销商强制订单吗？	1
董秘你好，公司有数字相控阵雷达技术储备？	请问董秘，公司有没有数字相控阵雷达技术储备？	1
您好董秘，很高兴贵公司能回购股票，也对贵公司的市值有了很明确的目标，但为何发公告至今毫无动作？是等着股东减持后压低再回购吗？如果从保护市值的角度出发，贵公司为何不直接从减持股东手中购入股票呢？现在的价格也远未到61呀？	你好，董秘。我很高兴贵公司能够回购股票，并对贵公司的市值有非常明确的目标，为什么到目前为止没有在公告中采取行动？它是在等待股东减持并回购吗？从市值保护的角度来看，为什么你的公司不从减持股东直接购买股票？现在的价格还不到61吗？	1
请问贵公司在储能方面的战略规划和已经投入的项目。	请问贵公司的储能战略计划和被投资的项目是什么？	1
您好，请问贵司现在股东人数多少？对于未来双碳有何规划	请问贵公司现在有多少股东？你对未来两倍碳排放的计划是什么？	1
你好，为什么不报6月30日的股东人数，你们就是对待投资者的吗	请问为什么不在6月30日公布股东人数呢？你是这样对待投资者的吗？	1
董秘您好： 我是我们上市公司的一名股东，因为近期英国采购丁腈手套引起热议，现能否提问一下贵公司目前在手订单是否充足，产能是否足够。 希望能够得到回复！	董秘你好：我是我们上市公司的股东。最近在英国购买腈手套引发热议，贵公司目前的订单是否足够，产能充足？我想要回信！	1
公司产品大量应用于新能源汽车领域，请问能否应用于汽车黑匣子EDR，有无已合作客户或拟合作计划？谢谢	该公司的产品广泛应用于新能源汽车领域，但能否适用于汽车黑匣子EDR，是否有合作客户或提出合作计划？谢谢你，谢谢	1
最近新闻公司研发了“远程智能流调系统”，能够为海关在疫情常态化下的防控标准提升保驾护航。作为公司的长期投资者，我对公司的发展非常有信心，也相信公司的管理水平和产品研发能力。请问在疫情下，各个口岸、机场，对优质防疫设备的需求激增，但为何公司作为智慧口岸、机场的龙头企业，在这大环境下业绩也没有足够提升？	近日，新闻公司开发了“远程智能流动控制系统”，可为海关在疫情常态化下提升防控水平保驾护航。作为公司的长期投资者，我对公司的发展非常有信心，对公司的管理水平和产品研发能力也很有信心。就此，局长可否告知本会，疫情下，各口岸及机场对优质防疫设备的需求大增，但为何该公司作为智慧港口及机场的领军企业，在这种情况下的表现仍未有充分改善呢？	1
您好，请问新冠otc试剂盒有在美销售吗？销量如何？本公司产品比九安医疗的有何优势？谢谢	您好，新冠肺炎的非处方药套件在美国有售吗？销售情况如何？我们的产品与九安医疗相比有哪些好处？谢谢你，谢谢	1
公司投资5亿多与政府合作年产20万台的电池箱体产品主要是为了供货哪个公司？？ 第二个问题，目前与下家公司是否已经有签署电池箱体合作协议？ 第三个问题，目前公司与吉利汽车合作的怎么样，主要有哪些产品？	该公司投资5亿多，与政府合作，每年生产200000套电池盒产品，主要供应哪些公司？第二个问题是，是否与下一家公司签署了电池盒合作协议。第三个问题，目前该公司与吉利的合作情况如何？主要产品有哪些？	1
请问到10.31股东人数是多少？	股东人数最多达到10.31人是多少？	1
请问公司是否有出口产品？产品主要出口到哪些国家？	这家公司有出口商品吗？产品主要出口到哪个国家？	1
您好！请问公司在大流水线方面是否有研发布局，谢谢	你好！公司是否在大管道上开发布局？谢谢。	1
石墨烯电池实车量产测试开始了吗，20年底已到	石墨烯电池的量产测试开始了吗？20年的结束已经到来。	1
你好董秘，年产10万吨的新增产能年底能投产吗，如果投产是否出现产能过剩	请问董秘，年产100000吨的新增产能能在年底前生产吗？如果开始生产，有没有产能过剩？	1
您好董秘，贵公司浙江板块，浙江的共同富裕，贵司有没有参与，公司股价已经破发有没有打算回购等，经营利润如何，谢谢	您好，董秘，贵公司浙江板块，浙江共同繁荣，贵公司是否参与，公司股价是否已被打破，是否计划回购等，营业利润如何，谢谢	1
请问，截至九月 30日公司的股东总数是多少？谢谢	请问到9月30日，该公司股东总数是多少？谢谢你，谢谢	1
公司有没有为河南、深圳疾控中心提供技术产品服务？谢谢	公司是否为河南省和深圳市疾控中心提供技术产品和服务？谢谢你，谢谢	1
公司自主研发的电源管理IC可以应用在新能源汽车吗？有哪些客户？	该公司自主研发的电源管理IC能否应用于新能源汽车？有什么样的客人？	1
公司是否能发展智能物流站	该公司能否发展智能物流站？	1
请问董秘，股价自高点已腰斩，请问董秘，明年计划产能是多少？目前铁矿石价格同比情况如何？	董秘，股价自高点以来已经跌价，董秘，明年计划的产能是多少？目前铁矿石价格同比情况如何？	1
贵公司有参与数字货币桥项目的研究吗？或者贵公司有数字货币桥相关业务吗？	贵公司是否参与数字货币桥牌项目的研究？或者，您的公司是否拥有与数字货币桥相关的业务？	1
您好，贵公司有业绩预告吗？如果有麻烦早点公告！另公司吉安一期产能现在月产能是多少？完全达产预计是今年几月份？谢谢	请问贵公司有业绩通告吗？如有任何不便，请尽快告知！此外，集安一期月产能有多少？计划今年哪个月份全面投产？谢谢你，谢谢	1
尊敬的董秘，你好，请问公司光伏逆变器和储能变流器相较其他企业的产品壁垒在哪里？上述两种产品目前出货量能否仍保持国内前三的标准，谢谢。	亲爱的董秘，您好，与其他企业相比，该公司光伏逆变器和储能转换器的产品壁垒在哪里？上述两款产品目前的出货量是否还能维持国内前三的标准，谢谢。	1
董秘您好！截止今天（10月27日），公司股东人数是多少？	董秘你好。截至今日(十月二十七日)，公司的股东数目是多少？	1
董秘你好！请问公司截止11月23日股东人数？谢谢！	你好，董秘！你能告诉我公司在11月23日之前的股东数量吗？谢谢。	1
董秘您好，请问截止7月9号，贵公司的股东人数是多少?谢谢	董秘你好。截至7月9日，贵公司的股东人数是多少？谢谢你，谢谢	1
董秘，您好，请问截止2021.11.5，公司最新股东人数是多少？	董秘您好，到2021.11.5，公司最新股东人数是什么？	1
请问贵司三季度锂盐销售多少吨，收入多少?有没有贡献净利润？多谢！	请问贵公司第三季度销售多少吨锂盐？营业多少钱？你对净利润有贡献吗？谢谢。	1
公司建有年产能 3,661万立方米的天然气制氢装置，通过管道直接供应给集中区内企业，近三年的产能利用率在40%左右。1、是否考虑把产能提高到100%满产？2、氢气销售额是多少？	该公司已建成年产3，661万立方米天然气制氢装置，通过管道直接供应给集中区企业，近三年产能利用率达40%左右。1.考虑将产能提高到100%满负荷？2.氢的销售量是多少？	1
公司在新能源汽车轻量化有什么布局和优势呢？	公司在新能源汽车轻量化方面有哪些布局和优势？	1
请问公司上市至今有做过增持，回购等呵护市场的具体行动吗？公司如何把握三年国企改革？	上市以来，该公司是否采取增资、回购等市场保护的具体行动？公司如何把握国企三年改革？	1
12月14日上市公司股东人数。	12月14日上市公司股东数量。	1
亲爱的董秘，您好！ 公司产品多次中标中核海得威。网上了解到中核海德威是专业的幽门杆菌检测机构。公司在可用于幽门杆菌检测上产品有哪些？	尊敬的董秘，你好？该公司的产品多次中标，中标核心Hedway。网上了解到，中国核海德威是一家专业的幽门螺杆菌检测机构。该公司的哪些产品可用于幽门螺杆菌检测？	1
请问公司的光刻机项目还在推进吗？还是已经放弃了？请正面回答，谢谢！	请问该公司的光刻项目还在进行中吗？还是已经放弃了？请直接回答。谢谢。	1
您好，友邦吊顶今年四月份推行了股权激励，以2020年业绩为基础，到2023年，友邦销售额要增长不低于120%，净利润要增长不低于152%，相当于到了2023年，友邦年销售额要达到16.6亿，请问友邦目前的产能是否足够满足？未来是否会扩大产能？新开门店数量是否有增加？	您好，友邦保险将于今年4月起实施股权激励。按2020年业绩计算，到2023年友邦销售额将增长120%以上，净利润增长不低于152%，相当于友邦到2023年的年销售额将达到16.6亿。友邦保险目前的产能足够吗？未来是不是要扩大产能？新店的数量增加了吗？	1
您好！请问目前公司有多少股东？	你好！公司目前有多少股东？	1
你好，公司大股东不是解禁了吗？怎么还不能流通？是什么原因	请问公司的大股东是不是被解禁了？为什么不能流通呢？原因是什么？	1
董秘您好，我是新益昌的投资者，新益昌作为miniLED固晶机的龙头，深度受益于miniLED行业的发展，据了解，新益昌已经是众多客户的供应商，但是目前还不是苹果的供应商，根据之前的纪要，公司预计2022年推出180K效率的固晶机，请问是否有计划打入苹果供应链？	董秘，您好，我是新宜昌的投资人。作为微型LED水晶机的领军者，新宜昌受益于微型LED产业的发展。据了解，新宜昌已经是众多客户的供应商，但目前还不是苹果的供应商。根据此前的会议记录，该公司计划在2022年推出180K效率的固体结晶机。有没有计划进军苹果供应链？	1
请问子公司强瑞软件主要有哪些突出产品？	子公司强瑞软件的主要优秀产品有哪些？	1
您好，请问可以介绍一下宿迁高性能纤维项目建设进展？期待您的回答，谢谢！	请问能介绍一下宿迁高性能纤维项目的建设进展吗？恭候您的回复。谢谢。	1
请问公司在6G和元宇宙上有没有技术储备和研发投入？	该公司是否在6G和代谢方面拥有技术准备和研发投入？	1
尊敬的董秘，您好：公司4季度的产能利用率怎么样？明年一季度的订单情况是否良好？	尊敬的董秘，公司四季度产能利用率如何？明年第一季度订单情况良好吗？	1
公司生产的气凝胶产量多少？在汽车及动力电池领域有哪些应用？	这家公司生产的埃洛格尔产量是多少？在汽车或动力电池领域有哪些应用？	1
公司并购晟天后，主营业务、收入占比有很大变化，符合更名规定，建议公司改名为川发光磁。	盛日并购后，主营业务和收入占比变化较大，符合更名规定。该公司建议更名为磁发射机。	1
你好截止18号股东人数是多少	请问到18日的股东人数是多少？	1
董秘您好，请问截止11月30日股东人数，谢谢。	董秘你好。你能告诉我截至11月30日的股东人数吗？谢谢。	1
贵公司产品在同行业竞争中有哪些优势呢？	在同行业的竞争中，你们的产品有哪些优势？	1
董事长你好。请问截至11月30日，请问截止11月30日收盘股东人数是多少，谢谢。	你好，主席。截至11月30日，截至11月30日的收盘股东人数是多少？谢谢。	1
请问董秘，公司产品有应用于军工吗？	请问董秘，该公司的产品是军工用的吗？	1
董秘您好，请问浙江绍兴的康隆达是否是贵公司的竞品公司，其停工停产是否会使贵公司订单增加？	董秘你好。请问浙江绍兴的康龙达不是你们的竞争对手吗？停产可以增加你们的订单吗？	1
请问目前股东数量多少	目前的股东数量是多少？	1
现有股东户数多少？	现有股东家族的数量是多少？	1
据了解，核苷酸是医美整形产品之一，请问公司产品是否应用于核苷酸医美领域？谢谢	众所周知，核苷酸是化妆品之一。该公司的产品是否被用于核苷酸药物领域？谢谢你，谢谢	1
董秘你好，二季度产能是否比一季度增加？	你好，董秘。第二季度的产能是否高于第一季度？	1
请问公司今年上半年经营情况是否达到管理层预期，是否延续去年增长的良好趋势？	请问公司今年上半年的经营业绩是否达到管理层的预期？是否延续了去年增速的良好态势？	1
光伏玻璃什么时候可以生产	什么时候可以生产光伏玻璃？	1
是哪个股东最近一直在减持？	哪个股东最近一直在减产？	1
请问贵公司是否有设备运用到高铁，公路基建等工程上？是否有相关基建的订单和合作	贵公司是否有高铁、高速公路基础设施等项目的设备？有没有相关基础设施的订购和合作	1
研究euv光刻机有相关这方面的专利吗	极紫外光刻机的研制有相关专利吗？	1
请公司学习伟大公司苹果，持续推出回购股份并注销，减少流通股份，提高每股收益	要求公司向伟大的公司苹果学习，继续发售股票回购和核销，减少流通股，增加每股收益	1
公司是否有和国内光刻机公司合作研发光刻机光源？	该公司是否与国内光刻公司合作开发光刻光源？	1
公司招股书中介绍产品涉及汽车智能仪表，是否有智能座舱研发生产？	根据公司招股书，产品与汽车智能仪表有关，有没有智能等级的研发生产？	1
您好，请问公司公告的半年报营业收入构成当中，其他产品主要是什么产品，涉及什么行业	请问公司发布的半年报收入构成中，还涉及哪些产品、哪些行业？	1
移速天猫店的65W氮化镓充电器和无线充电器是否是贵公司产品？	天猫的65W氮化镓充电器和无线充电器是你的产品吗？	1
公司在抗HIV方面有哪些项目？是自主研发还是合作研发？产品方面有没有在审的？谢谢	该公司在抗击艾滋病毒方面有哪些项目？自主研发吗？还是联合研发？有审查中的产品吗？谢谢你，谢谢	1
请问贵公司对欧美是否有业务?业务量占比多少？	贵公司与欧洲或美国有生意吗？业务量比率是多少？	1
尊敬的董秘您好！贵司上市后市值不断萎缩，士气大减，超募资金数十亿，简单存在银行，为何不回购股份以增强投资者信心？	尊敬的董秘，您好！上市后，你的市值不断缩小，士气大打折扣，募集的资金又多了几十亿，干脆存放在银行，回购股票，不提高投资者信心吗？	1
近期新疆和西藏发现新冠病人病例，目前公司是否有来自上述地区的收入？目前新疆工厂产能能否满足当地的需求？	近日，新疆和西藏发现1例新冠肺炎。公司是否拥有上述地区的收入？目前，新疆的工厂产能能否满足当地需求？	1
董秘您好！请问公司有没有新能源汽车业务？是新能源汽车电缆吗？还是其他产品？谢谢	董秘你好。那家公司有新能源汽车业务吗？是新能源汽车电缆吗？是别的产品吗？谢谢你，谢谢	1
公司订单饱满吗？在手合同多吗？应收款项是否能收回？	公司有很多订单吗？你们手头有很多合同吗？应收账款可以收回吗？	1
中国石化在湖北恩施发现超千亿方页岩气，请问公司 能参与该项目页岩气的开发？如参与，公司提供哪些产品服务？谢谢！	中石化在湖北恩施发现逾千亿页岩气的该公司能否参与该项目的页岩气开发？如果您参加了，该公司将提供哪些产品和服务？谢谢。	1
请问贵公司是否有军工业务？是否有设备可以用于军工，通信方面18	贵公司有军事业务吗？有没有可以用于军工和通讯的设备	1
你好，请问截至现在，公司的股东人数是多少？	您好，到目前为止公司的股东人数是多少？	1
贵公司产品用于工业传输以及物流搬运是否涉及物流物业？能否为智能物流提供效率？	您的产品是否用于与工业运输和物流特性相关的物流处理？它能为智能物流提供效率吗？	1
您好，董秘，5G基站是否会用到贵公司的产品?	请问董秘，你的产品用在5G基站吗？	1
公司具有车联网相关的业务吗？目前大概是一个什么规模？请介绍一下，谢谢！	该公司有关于车联网的业务吗？目前的规模是多少？请介绍一下。谢谢。	1
公司旗下那么多的足球学院，有否考虑制作一款中国的足球游戏？	这家公司旗下有这么多足球学院，你有没有考虑过打造中国足球赛事？	1
董秘你好！三峡能源以后的发展战略目标是什么？	你好，董秘！三峡能源未来发展的战略目标是什么？	1
陈总，您好:      非常感谢你上次对我提问的回答，让我了解到核电进入碳交易不是一时半会能得到世界同意的事。也许利用核电进行电解水制造低成本的绿氢在十年内看到的希望更大，不知贵集团有没有电解水制氢方面的技术储备或规划?利用核产生的废热加电，我相信核电在碳中和的道路上必定会发挥更大的作用。	你好，陈先生：感谢你上次对我问题的回答。这让我明白，核电站将进入碳交易，暂时不会接受世界的批准。10年后，使用核电电解水生产低成本绿色氢气的希望可能很大。我想知道你的小组是否有用电解水生产氢气的技术储备或计划。利用核电站产生的余热，我们相信核电站将在碳中和的道路上发挥更大的作用。	1
董秘您好，贵公司新营业范围的新兴能源技术研发指的是什么？	董秘，您好。你所说的在新业务范围内开发新能源技术是什么意思？	1
新能源汽车大力发展，锂电池需求大增，同时也带动了锂电池专用外壳的需求，请问公司锂电池专用外壳项目进展如何？	随着新能源汽车的蓬勃发展，对锂电池的需求大幅增加，也与锂电池专用外壳的需求息息相关。公司锂电池专用案例项目进展如何？	1
请问截止到2021年12月10日的股东总数？	截至2021年12月10日股东总数是多少？	1
你好，公司作为铝合金产品企业，请问公司在汽车轻量化零部件都有哪些产品？汽车轻量化是未来的发展趋势，公司在这方面业务如何	您好，作为铝合金产品企业，该公司在汽车轻量化零部件方面有哪些产品？汽车轻量化是未来的发展趋势。那家公司在这个领域的业务怎么样？	1
请问公司的许昌，焦作生产线用的炉子什么牌子的？生产效率如何？次品率如何？	该公司许昌，焦作生产线上使用的炉子是什么品牌？生产效率如何？不良率是多少？	1
贵公司在俄罗斯有没有业务开展？	贵公司在俄罗斯业务吗？	1
贵公司产品如何走出国门？	你们的产品怎么走出国门？	1
贵公司你好，9月份提出的锂电池新材料还有下文吗？请问贵公司在光伏材料上有无技术突破能否有价格优势呢？	你好，是你的公司。9月份有没有提出锂电池的新材料？请问贵公司在光伏材料方面有技术突破吗？有价格优势吗？	1
董秘，你好，截止今天的股东人数是多少？	董秘先生，您好，到今天为止有多少股东？	1
董秘您好，贵司今年订单确认问题，从交货到收钱，一季度正常，相比一季度，两、三季度的确认节奏有点问题，请董秘解释一下，谢谢。	董秘你好，今年的订单确认问题，从发货到到账，第一季度是正常的。与第一季度相比，第二季度和第三季度的确认节奏存在问题。请说明一下。谢谢。	1
董秘你好，刚按新闻集采，广东联盟里153个化药名单力有聚乙二醇干扰素-2b注射液，请问是贵公司报名得集采产品吗？能够具体说一下这个事情吗？	你好，董秘，刚才消息面显示，广东联盟153种化学药品均注射了聚乙二醇干扰素-2b。这是贵公司的注册收藏产品吗？你能告诉我更多关于这件事吗？	1
您好，请问截止11月19日，最新的股东人数是多少？	您好，到11月19日，最新的股东人数是多少？	1
董秘，您好，看到了今天公司主动披露的1-2月经营数据，公司业绩亮眼，但是股价却表现得很差劲，建议公司管理层增持股票，哪怕增持十手，百手都可以，以表明对公司未来的认可。	董秘你好。从公司今日披露的1-2月经营数据来看，公司业绩突出，但股价不佳。建议公司管理层增持股票，增资也要增资。为了表示对公司未来的认可。	1
请问公司有没有种植中药材，公司1月7日股东人数多少？贵公司的采购大麻和龙津药业有啥不同？	请问该公司是种植中药的吗？1月7日该公司的股东数量是多少？你购买的大麻和Long John Pharmtics有什么区别？	1
上海谱润到10月16日应该减持期满了吧，请董秘转告上海谱润：如有减持请走大宗交易！谢谢！	上海普润应至10月16日减持期限届满，请告诉上海普润：如有减持，请做大宗交易！谢谢。	1
请问一下，截止9月30日公司股东人数，谢谢。	告辞了。这是公司截至9月30日的股东人数。谢谢。	1
董秘你好，公司在微信公众号文中发表文章，表示奥雅设计战略投资奇异火科技 激活NFT领域深度合作。战略投资公司应该是属于重大事项，没有看到有公告，为什么没有发公告而选择在公众号发表？	你好，董秘，该公司在微信公众号发表文章称，欧雅设计战略将投资异国消防技术，激活NFT领域的深度合作。战略投资公司应该是一个重大问题，没有看到公告，为何选择不发布公告，在公众号发布？	1
贵公司与巴斯夫湛江基地项目的业务合作订单量有多少？	贵公司与巴斯夫湛江基地项目的业务合作订单是多少？	1
公司产品能否用于盐湖提锂？	该公司的产品可以用来从盐湖中提取锂吗？	1
疫情防控期间，公司有和抖音，京东，淘宝网等合作吗？足不出户可买产品和生活用品、卖了奶粉或医疗用品吗？谢谢	疫情防控期间，该公司是否与抖音、京东、淘宝等进行了合作？足不出户就能买到产品和日用品，卖奶粉或者医疗用品吗？谢谢你，谢谢	1
请问贵公司在食品安全方面有什么成熟有竞争力的技术或产品	你在食品安全领域有成熟的有竞争力的技术或产品吗？	1
面对当前形势及市场环境，公司是否有回购或者增持计划？	面对目前的形势和市场环境，公司是否有回购或增资计划？	1
董秘您好，请问截止1月10日收盘的股东人数，谢谢，祝一切顺利！	董秘你好。我想问一下1月10日闭市的股东人数。谢谢。祝你一切顺利。	1
请问公司焊材产品是否用到海工装备领域，比如船舶，海上平台，谢谢！	请问该公司的焊接产品是否用于船舶、海洋平台等海洋装备领域？谢谢。	1
请问贵公司精装修信息化建设项目进度如何？如何提高企业的市场占有率？	贵公司精装修信息化建设项目进展如何？如何提高企业市场占有率？	1
尊敬的董秘好，请问美的工厂生产了吗？什么时间投产出效？公司孑公司4家具体什么业务？生产什么产品！有无向新能源车提供配件业务？美的工厂与4个子公司并表财务指标了吗？今年分红有无高送转？为什么公司股价自上市一直不涨？请给予答复！谢谢！顺祝宏昌业务大增！并祝你工作顺利！身体健康！	亲爱的董秘，梅花工厂已经生产了吗？什么时候能生产？那家公司的四家公司的具体业务是什么？生产什么样的产品？有新能源汽车的零部件业务吗？美的工厂是否将财务指标与四个子公司合并？今年红利高吗？为什么该公司上市以来股价一直没有上涨？请给我答案！谢谢。祝愿宏昌繁荣昌盛。祝你在工作中一切顺利。祝你身体健康。	1
请问新成立的天圆地方环境公司是否有接到项目订单，金额多少？	请问新成立的天元地方环境公司是否接到项目订单？金额是多少？	1
请问公司的产品有哪些？	这家公司的产品是什么？	1
董秘你好！公司是生产什么产品的？消费类电子产品具体是啥？另外公司近期产能负荷率是多少？	你好，董秘！这家公司生产什么样的产品？什么是消费电子产品？另外，该公司最近的开工率是多少？	1
你好，请问贵公司控股子公司内蒙古圣泉科利源新材料有限公司是否是打造稀土多功能材料和高端合金材料研发？请问是否有研发成果？是否已经产生了利润?	您好，您的控股子公司内蒙古圣泉科力源新材料有限公司是不是做了稀土多功能材料和高端合金材料？有什么研发成果吗？盈利了吗？	1
董秘好，公司持股5%以上股东深圳市创新投资集团有限公司及其一致行动人通过大宗交易减持的股份接受方有锁定期吗？	董美浩，拥有公司5%以上股份的深圳市创新投资集团有限公司及其联合行动人以大宗交易方式减持，有禁售期吗？	1
请问贵司是否有供应VR设备相应的原材料或元宇宙技术储备？	贵公司是否为VR设备提供相应的原材料或超航天技术储备？	1
现在万科已经跌破市净值，请问贵公司有没有回购计划？	目前万科已经跌破净值，你们公司有回购计划吗？	1
董秘您好，请问贵公司在汽车芯片研发方面有没有相关的业务和成果？	董秘，您好，贵公司在汽车芯片研发方面有相关业务和成果吗？	1
董秘，你好，股价已经明显跌破净资产，公司准备什么时候回购股份了？谢谢	你好，董秘，股价明显跌至净值以下。公司打算什么时候回购股票？谢谢你，谢谢	1
请问公司四元锂电池正极材料是否已具备量产能力？目前已销售多少？截止目前公司股东人数是多少？	公司是否具备量产四元锂电池正极材料的能力？到目前为止卖了多少？到目前为止，股东人数是多少？	1
您好！有几个问题想向公司领导请教： 1、公司的DC-DC电源管理芯片是否采用BCD工艺？ 2、公司的DC-DC电源管理芯片可以量产的产品中，最高电压等级能达到多少伏？ 谢谢！	你好！有几个问题。我有件事想问公司领导：1.公司DC-DC电源管理芯片是否采用BCD工艺？2、公司DC-DC电源管理芯片可量产，最高电压水平可达多少伏？谢谢。	1
你好，能像其他上市公司那样回应下:公司现阶段订单如何，同比去年增长率是多少？感谢答复。	请问您可以像其他上市公司一样应对：公司现阶段的订单情况如何？与去年相比增长速度有多快？谢谢您的回信。	1
董秘您好！我们公司是否有芳纶产品？或者是涉及到芳纶的相关产品？能不能用于锂电池隔膜或粘结剂？	董秘你好。我们公司有芳族聚酰胺产品吗？还是芳族聚酰胺相关的产品？可以作为锂电池的隔膜或粘合剂使用吗？	1
请问公司的激光成像生物医疗设备项目进展如何了？	该公司的激光成像生物医学设备项目进展如何？	1
全国每年生产销售两千多万辆汽车，公司的保险杠占比多少？	全国汽车产销量每年超过2000万辆。该公司保险杠的比例是多少？	1
董秘您好，公司有参与锦屏地下实验室建设吗？公司参与此项目在产品及技术上有何领先优势？	董秘您好，公司是否参与了金平地下实验室的建设？该公司在参与该项目的产品和技术方面具有哪些领先地位？	1
尊敬的董秘您好，中国登记结算公司每个月10日20日和月底会主动下发股东名册的，请问截止到11月30日，贵公司股东人数是多少？	尊敬的董秘表示，中国注册结算公司将于每月10日、20日和月底自愿公布股东名单。到11月30日，贵公司的股东人数是多少？	1
董秘你好，廖真把255万股票在二级市场转卖给武汉私募？请问这个操作，有提前公布减持计划吗？符合交易规则吗	你好，董秘。廖镇在二级市场转售255万股到武汉私募？请问这次行动前有减持计划吗？那个符合交易规则吗？	1
请问，公司主要进行哪些职业教育	请问该公司主要开展哪些职业教育？	1
建议公司可以加大核心技术研发力度，像戴森那样不仅有颜值，技术含量也是棒棒的。	公司可以致力于核心技术的研发，就像戴森一样，不仅颜值，技术含量也不错。	1
看到公司有参与湖南省相关部门牵头的人工肺研发，请问公司目前的核心技术工艺是否与人工肺的设备以及耗材具有相关性？目前是否有相关的技术储备？谢谢	由于该公司参与了湖南省相关部门牵头的人工肺研发，该公司目前的核心技术是否与人工肺设备和耗材有关？目前是否有相关的技术储备？谢谢你，谢谢	1
董秘你好，公司和华为有合作吗？请问公司是华为的客户吗？	请问董秘，该公司是否与华为合作？该公司是华为的客户吗？	1
您好，目前有mini LED和军工航天的订单吗？	您好，现在有迷你LED和军用太空订单吗？	1
请问董秘11月30日股东户数是多少	董秘，11月30日的股东人数是多少？	1
董秘你好，面对原材料价格的波动情况，贵司产品最近是否有提价计划？	你好，董秘。面对原材料价格波动，近期有没有计划上调产品价格？	1
晶科科技于11月9日缩量涨停，当晚晶科科技发布大股东减持晶科转债可转债公告，是否有操纵股市行情嫌疑。	晶科科技11月9日库存涨价，当晚晶科科技发行大股东减少晶科转债，是否涉嫌操纵股市。	1
你好！请问公司研制的新一代通信产品可以用在民用方面吗？将来会用于民用吗？	你好！该公司开发的新一代通信产品可以用于民用吗？它将来会用于私人用途吗？	1
请问公司高功率IGBT目前是否有在研产品？	该公司的大功率IGBT目前有没有正在开发的产品？	1
贵司供应商众多，结合现在公司股价现状，请贵司召开供应商大会，积极引导供应商参与到公司的市值管理上来，这样即使股东又是合作，大家才能走得更远。	贵公司供应商众多，请结合公司股价现状，召开供应商大会，让供应商积极参与公司市值管理。这样的话，即使股东合作，我们也会走得更远。	1
公司在选择单纵模以及基横模提高相干性方面 是否具有比竞争对手更好的核心技术?   应该如何能平衡谐振腔使用过程中的稳定性 来稳定激光器的功率？	在选择单一纵向模式和基本水平模式以提高一致性方面，该公司是否拥有比竞争对手更好的核心技术？如何平衡谐振器的稳定性以稳定激光器的功率？	1
您好，请问公司目前订单项目是否充足？	请问公司目前的订单量够吗？	1
请问下贵司最新股东人数多少？	贵公司最新的股东人数是多少？	1
您好，鱼跃的防压疮气垫可否适用于医院病房长期卧床场景？产品有相关的医疗器械认证资质吗？谢谢！	请问鱼跃防褥疮气垫适用于医院病房长期卧床休息吗？产品是否具有相关的医疗器械认证资质？谢谢。	1
尊敬的董秘，请问12.20日收盘的股东数是多少？	尊敬的董秘，12.20当天收盘价的股东是多少？	1
请问一下贵公司或者子公司有国内飞机客户的订单吗？ 如有，能了解是涉及哪些部件吗？另外是民用机还是军用机呢？	请问贵公司或子公司有国内飞机客户的订单吗？如果是这样的话，你能知道它涉及到哪个部分吗？另外，是民用飞机还是军用飞机？	1
请问截止2022年3月20日收盘股东人数。谢谢	请问到2022年3月20日，被关闭的股东多少钱？谢谢你，谢谢	1
董秘您好！1、请问公司是否是氢能源的上游企业？2、请问公司截止今天为止股东人数是多少？	董秘你好！1.公司是氢能上游企业吗？2.公司到今天的股东数量是多少？	1
贵公司拥有氢能源储存设备的生产能力吗？	贵公司有储氢设备的生产能力吗？	1
您好，公司订单排到明年二三季度了，那么明年有新增产能多少？	请问公司的订单预计在明年的第二季度或第三季度，明年有多少新的产能？	1
董秘您好,请问贵公司与国内哪些大型车企就整车物流发展达成了战略合作协议?	董秘先生，请问国内有哪些大型车企与贵公司就发展整车物流达成战略合作协议？	1
您好，请问，贵公司截止11月10日股东人数是多少？谢谢！	请问到11月10日，你们公司的股东人数是多少人？谢谢。	1
董秘，你好，能否说一下到2021年11月10股东人数，目前公司订单怎么样?	董秘你好。你能告诉我截至2021年11月10日的股东人数吗？该公司目前的订单是什么？	1
上市后股价跌跌不休，前景堪忧！为增加股友信心，公司高管考虑增持吗？	上市后股价下跌经久不息，前景堪忧！为了增强股东信心，高管是否考虑增收？	1
公司募资上市以来，产品扩张了多少？有没有延伸其他产业链来增加公司的收入跟盈利能力.	自该公司筹集上市资金以来，该产品的规模扩大了多少呢？其他产业链的延伸并不是为了增加公司的收入和盈利能力。	1
春晚高清直播和冬奥会开幕式均用到博汇科技的方案和产品。未来电视直播和互联网直播将引入沉浸式直播体验，元宇宙直播。国内外互联网巨头纷纷抢占元宇宙技术高地。请问公司是否开始从战略上重视元宇宙？	无论是春晚高清直播，还是冬奥会开幕式，博汇的解决方案和产品都在使用。未来，电视直播和互联网直播将引入沉浸式直播体验、元巴斯直播。国内外互联网巨头纷纷抢占梅塔巴斯的技术高地。公司是否开始重视梅塔巴斯的战略重要性？	1
截止10月20日股东人数？谢了！	到10月20日的股东人数是多少？谢谢。	1
您好，请问贵公司募投项目投产进度情况，建设到什么情况了？新产能大概什么时候投产？谢谢	请问您能告诉我贵公司的筹资项目进展如何吗？建设要多长时间？新产能什么时候投产？谢谢你，谢谢	1
请问公司董事长说运营商估值重估也只是嘴上说说吗？能带头增持股份吗？大股东能回购股份吗？	我想请该公司的主席说，重新评估经营者的评估只是口头上的？你能带头增持吗？大股东会回购股票吗？	1
连续几天拨打公司公布的对外联系电话，自动语音要求拨打分机。但查询分机号无人接听，转总机也是无人接听。最终结果就是，如果不知道你们证券分机号的话，根本就无法通过电话联系你们。前面咨询股东人数，别家公司都会直接回复，但你公司却以保护投资者为由不予回答。请问公司就是这样对待投资者吗？	我会连续几天打电话给公司公布的联系人，要求你用自动语音拨打分机。但查询分机号码无人接听，总机也无人接听。最终的结果是，如果不知道自己的证券内线，就无法通过电话联系。在咨询股东人数时，会有其他公司的直接回复，但您的公司不会以保护投资者为由回复。这就是该公司对待投资者的方式吗？	1
公司的产品广泛应用于充用桩设备，请问公司目前在充电桩领域是怎样的布局，是否已有应用业务在进行？	该公司的产品广泛应用于充电桩设备。该公司目前在充电桩领域的布局如何？有办理的申请业务吗？	1
贵公司产品在汽车智能音响占有率有多少？	您的产品在车载智能音响中的占有率是多少？	1
贵公司股价已经严重破发，是否有回购计划？	你的股价严重下跌，有没有回购计划？	1
请问公司是否有LED光源的智能灯产品，产量大不大。谢谢。	请问该公司有LED光源的智能灯具产品吗？产量不大。谢谢。	1
请问贵公司硅片切割用的金刚线主要供应商有谁？	贵公司切割硅片用金刚石长丝的主要供应商是谁？	1
您好。贵司的招股说明书、年报、券商对贵司的研究报告都没有提到贵司有光子技数。请问光子技数是否比贵司的现有核心技术更迭代先进？贵司是否没有研发光子技数？如贵司有研发，请问贵司的光子技数将具体应用在哪个产品？贵司的光子技数产品预期将何时产业化批量推向市场？谢谢	你好。贵公司的招股书、年报和券商没有就贵公司的研究报告提及贵公司具有光子技能。光子技术是否比现有的核心技术更先进？你的公司还没有开发光子技术吗？如果贵公司开发了，您的光子技术将应用于哪些产品？您的光子技术产品产业化预计何时投放市场？谢谢你，谢谢	1
公司即将投资技改的高性能覆铜板主要用于什么产品？谢谢。	该公司拟投资的高性能铜张板使用哪些产品？谢谢。	1
贵公司的业务场景有没有实现在vr技术上的储备！为了抖音直播可能构建VR实体场景的形式	贵公司的业务场景是否实现了VR技术储备？抖音中继使构建VR实体场景成为可能。	1
董秘您好，公司二级市场跌幅巨大，强烈建议回购增持，维护公司形象，谢谢	董秘，您好。该公司二级市场出现大跌。强烈建议回购和增资以维持公司形象。谢谢。	1
请问公司有涉及数字货币业务吗？	该公司是否涉及数字货币业务？	1
公司年报披露，新建5G陶瓷介质滤波器生产项目进入试生产阶段，试产品已在下游相关客户进行验证；投资建设用于5G通讯及汽车新能源电池包的紧固件生产项目已在进行规划设计等前期准备工作。目前该项目进展如何？客户有订单了吗？	公司年报显示，新增5G陶瓷介质过滤器生产项目已进入试生产阶段，试制产品已通过下游相关客户验证；投资建设5G通信，汽车新能源电池组紧固件生产项目已开展规划设计等前期准备工作。到目前为止，这个项目是如何进行的？您有点菜吗？	1
公司管理层对未来的经营状况有一个相对准备的把握，请财务部门提供一个公司4季度的盈利预期！提供一下公司未来3-5年的盈利预测？	要求公司管理层充分掌握未来经营形势，为财务部门提供公司第四季度盈利预测！提供公司未来3-5年的盈利预测？	1
公司未盈利，对于公司来说，临床进展，产能扩建进展，各种审批进展，以及研发情况，难道不应该及时向投资者说明吗？难道公司认为20年11月20号时候的那种交易情况是正常的吗？有没有自查是否有人泄漏这些信息？	公司无利可图，对公司而言，临床进展、扩张进展、各种审核进展，以及研发，是否应适时向投资者解释？该公司认为11月20日、20日这样的交易正常吗？你有没有检查过自己，看看有没有人透露了这个信息？	1
公司在前期互动中明确表示十分看好未来空间发展，但是为何公司上市后股价长期低迷，跌幅远超同期上市的创业板公司？是公司的研发与市场脱节的原因么？公司目前的经营情况如何？为何公司上市募资后没有看到公司有明显的发展？谢谢	在前期的互动中，公司明确表示非常看好未来空间的发展，但为何上市后公司股价长期低迷，且跌幅远高于同期上市的创业板？这就是公司研发与市场脱节的原因吗？公司目前的经营状况如何？为什么上市募集后，该公司没有看到明显的发展？谢谢你，谢谢	1
请问下公司的主要客户有哪些？公司手表新产品除了小米量产外，还有其他哪些品牌在量产了？	公司的主要客户是什么？除了小米，该公司的新手表产品还有哪些品牌量产？	1
请问，截至2022年2月28日，公司的股东数是多少？谢谢	请问到2022年2月28日，该公司的股东数量是多少？谢谢你，谢谢	1
公司目前有无可降解塑料原料产品？市场价格如何？谢谢	该公司目前有可降解塑料原料制品吗？市场价格是多少？谢谢你，谢谢	1
请问 截止10月10日收盘，贵公司股东人数是多少？谢谢	截至10月10日收盘时，贵公司的股东人数是多少？谢谢你，谢谢	1
您好，请问公司有储备冷喷涂3D打印技术吗?	请问公司有保留冷喷雾3D打印技术吗？	1
王立强作为董事长，持股比例非常低，王立强明明有资金持股更多，为什么不这么做呢？	王立强担任董事长，持股比例较低，王立强显然有资金增持股份，但乐于什么呢？	1
工业和信息化部办公厅印发《关于启动新能源汽车换电模式应用试点工作的通知》，换电站也被写入政府工作报告。换电多了，必然会有消防安全事故，特斯拉澳大利亚和北京造成的人员伤亡和经济损失都很严重。国安达有什么战略	工信部办公厅印发“关于启动新能源汽车换电模式试点应用的通知”，变电站也被写入政府活动报告。如果换电太多，不可避免地会发生消防安全事故。特斯拉澳大利亚和北京造成了严重的伤亡和经济损失。国安达的战略是什么？	1
尊敬的董秘你好，请问贵公司的产品市场占有率是多少？可比性的有几家公司？谢谢	尊敬的董秘先生您好，贵公司产品的市场占有率是多少？有几家可以比较的公司？谢谢你，谢谢	1
公司在一季报中提到可降解塑料生产线已经达到五万吨量产能力，请问现在已经开始生产了吗？订单需求情况怎样？还有进一步扩产计划吗？谢谢！	该公司在季度报告中提到，可降解塑料生产线达到5万吨的量产能力。这个从现在开始生产了吗？这个订单的需求量是多少？有计划进一步扩大生产吗？谢谢。	1
请问公司新增产能涉及产品是否已有意向客户洽谈销售？	请问该公司的新产能是否涉及原本打算与客户洽谈销售的产品？	1
数字货币是元宇宙的重要组成部分，请问公司在元宇宙数字货币方面是否有相关研发储备，公司战略发展方向上是否考虑未来元宇宙的发展及应用？	数字货币是元巴斯的重要组成部分。公司是否拥有与梅塔巴斯相关的研发储备？公司是否将梅德巴斯未来的发展和应用考虑为战略发展的方向？	1
尊敬的董秘，随着疫情的反复，全民注射第三针疫苗，与我们国家担当社会责任，无偿赠送国际社会抗疫物资与疫苗还有有偿出口，拉动疫苗与防护服的大量需求，公司产能是否跟得上？还有公司有没有拓展除国药以外的疫苗生产企业？	亲爱的董秘，随着疫情再次发生，全民注射第三剂疫苗，他们通过向国际社会免费发放防疫物资和疫苗以及有偿出口，承担起对我国的社会责任，提高了对疫苗和防护服的大量需求。那家公司的生产能力跟上了吗？除了中药，有没有其他公司扩大疫苗生产企业？	1
公司最新公告的甘肃甬金项目，之前福建广东的产能有距离青山较近的运输成本优势，甘肃的产能上游主要是哪家钢厂？还会有运输成本优势吗？	该公司最新公布的甘肃永进项目，在福建省产能具备接近青山的运输成本优势之前，处于甘肃产能上游的主要是哪家钢厂？又有运输成本的好处吗？	1
董秘同志你好，请问截至12月3日收盘，公司股东户数多少？非常感谢你的耐心回答！	董秘先生，您好，到12月3日，公司的股东数量是多少？感谢您耐心的回答！	1
尊敬的董秘！你好！公司的产品有应用到新能源汽车么	尊敬的董秘！你好！那家公司的产品适用于新能源汽车吗？	1
您好，贵司实时股东人数是多少？	请问贵公司的实时股东数量是多少？	1
董秘您好，请问截止到2022年3月20日股东人数是多少？谢谢。	董秘，您好，到2022年3月20日，股东人数是多少？谢谢。	1
请问公司儿科类中医药产品主要客户是公立医院还是连锁药店？	请问该公司儿科中药产品的主要客户是公立医院吗？还是连锁药店？	1
请董秘介绍一下公司主营产品及其毛利率、公司产能使用率、是否有产能扩建需求、规划。谢谢！	公司主要产品及其毛利率，公司产能利用率，是否有扩张需求，请介绍计划。谢谢。	1
董秘你好！ 问下股东人数现在多少？	你好，董秘！目前的股东数量是多少？	1
截止3月31日，公司股东人数是多少？谢谢	截至3月31日，股东人数是多少？谢谢你，谢谢	1
董秘，你好，贵公司有涉及人工智能方面业务或者绿色节能相关业务么？如果有能不能介绍一下？智能灯杆目前会大批量替换旧灯杆么？	请问董秘，贵公司有没有关于人工智能和绿色节能的业务？如果是的话，可以给我介绍一下吗？智能指示灯是否会大量代替旧杠杆？	1
最近海外疫情负重，公司的小分子试剂，蛋白，或许酶方面的研究产品销量有没有明显提升？	随着近期海外疫情负荷，该公司小分子试剂、蛋白质和酶的销售是否显著增加？	1
请问董秘，贵公司在元宇宙领域是否有合作和应用，未来5G和元宇宙领域是否有更深层的研发和规划？希望能看到更多贵公司的利好消息，可以提振兆龙互联股价。	董秘，贵公司在梅塔巴斯领域是否有合作和应用？未来在5G或元巴斯领域有没有进一步的研发和规划？希望贵公司能看到更好的消息，这能提振兆龙互联的股价。	1
董秘您好，创业板上市企业（稳健*疗）2021年以提供线上优惠券的方式对在册股东回报感谢，成大是否可以借鉴类似营销方式，未来增加投资者与公司的互动，不仅正向回馈股东，同时也促进自身产品的销售。	您好，董秘，创业板上市公司(稳健*疗法)2021年提供网络政客回报得益于注册股东。成大未来能否借鉴类似的营销方式，增加投资者与公司的互动？不仅还原给股东，还促进了本公司产品的销售。	1
您好，请问贵公司的产品或技术在大飞机上有应用吗？针对传统工艺或产品，贵公司的优势体现在哪里？	请问您的产品或技术在大型飞机上有什么应用吗？在传统工艺或产品方面，贵公司有哪些好处？	1
公司“抗新冠肺炎药磷酸氯喹中间体 APA的连续化新工艺开发 ”项目进度是否已经完成？谢谢	公司“抗新冠肺炎药物磷酸氯氮酮中间体APA持续新技术开发”项目进展情况如何？谢谢你，谢谢	1
请问公司核心技术人员离职对公司业务有什么影响吗？	公司核心技术人员的离职是否对公司业务有影响？	1
董秘您好，贵司的产品上半年销售如何？产能利用率如何？	董秘，您好。贵公司上半年的产品销售情况如何？生产能力的利用率是多少？	1
董秘您好，请问截止12月20日股东人数？谢谢！	董秘，请问可以告诉我截至12月20日的股东人数吗？谢谢。	1
请问贵公司：贵公司上市以来有没有商誉减持？	请问贵公司：贵公司上市以来，营业权有没有下降？	1
贵企业离台海这么近，如解放台海，贵公司产品可做出什么贡献？	你的公司离台湾海峡这么近，如果你解放了台湾海峡，你的产品怎么能贡献？	1
请问截至12月24日，公司的股东人数是多少，谢谢！	请问到12月24日，公司股东人数是多少？谢谢你！	1
公司7月份披露说2021年储能变流器出货量约100MW。那2022年上半年储能变流器出货量多少GW？上半年储能变流器的销售额有多少？	该公司7月时披露，2021年储能转换器出货量约为100兆瓦。储能转换器2022年上半年出货量是多少？上半年储能转换器销售情况如何？	1
公司目前的产能利用率有多少？	该公司目前的产能利用率是多少？	1
请问高迪女士，截止目前最新的股东人数是多少？谢谢！	告辞了。高迪先生，迄今为止最新的股东数量是多少？谢谢。	1
公司产品能否应用到VR及AR声学领域？	我们的产品能否应用于VR和AR音响领域？	1
董秘，您好，请问截止2021年12月20日，咱们的股东户数是多少，谢谢！	董秘，请问2021年12月20日前有多少股东？谢谢。	1
请问截止目前，公司股东人数为多少，谢谢！	到目前为止，该公司的股东数量是多少？谢谢。	1
请问，近期启动的国家一期风光大基地项目，是否在集团十四五的发展规划中？是否算是计划之外的项目？请详细介绍当前公司参与的内蒙古库不齐、青海、甘肃等地的一期风光大基地项目，项目装机规模、投资额度以及预计的并网时间？	请问国家风景区一期工程是不是最近在集团的14、5规划中启动的？这是计划外的项目吗？请详细说明该公司在内蒙古、青海、甘肃等地参与的景区大基地一期工程、项目设置规模、投资额及预计投放时间。	1
您好，请问，贵公司截止10月20日股东人数是多少？谢谢！	请问到10月20日，你们公司的股东数量是多少？谢谢。	1
董秘你好！公司产品所需要的芯片受美国制约吗？影响面有多大？	你好，董秘！那家公司的产品所需的芯片受到美国的限制吗？影响有多大？	1
公司产品有没有应用于基建项目	该公司的产品是否用于基础设施项目？	1
董事长你好！请问公司抛开新冠病毒疫苗，凭公司现在已经投放市场的疫苗和在注册审批的新开发疫苗，公司所描绘的前景是怎么样的？今年计划的销售收入会达到什么水平？净利润会比2020年有明显的增长吗？在未来几年公司的总体战略目标是什么？谢谢！	你好，主席！我想让你把新型菌落病毒疫苗置之不理，随着该公司已经上市的疫苗和新开发的注册和批准的疫苗，该公司解释的前景是什么？今年的计划销售收入将达到什么水平？净利润会明显高于2020年吗？公司未来几年的总体战略目标是什么？谢谢。	1
最新资料显示，中金公司丰众36号员工参与创业板战略配售集合资产管理计划在上市时持有的237.43万股在最新的三季报只剩181.33万股，而资料上显示此持股计划的解禁时间是明年5月10日。请董秘认真回答公司的员工持股计划是否存在违规减持的现象？	最新数据显示，中国国际金融公司丰中36名员工上市时参与创业板战略配售集资合资管计划的237.43万股，仅为最新三期报的181.33万股，而数据显示，该持股计划将于明年5月10日解禁。请认真回答董秘。公司员工持股计划是否有违规减持行为？	1
董秘您好，请问贵公司的产品在国内市场和国外市场都有销售吗？	董秘，您好。你们的产品有在国内外市场销售吗？	1
为了打造新的产业增长极，同时践行绿色发展战略，落实国家碳达峰、碳中和有关政策要求，建议贵公司利用卖出的东北证券股权资金，大力发展新能源，储能以及光伏产业，打造新的利润增长点！	为打造新的产业增长极，落实绿色发展战略，落实国家碳峰和碳中和的相关政策要求，贵公司建议利用出售的东北证券股权基金，大力发展新能源、储能和光伏产业。创造新的利润增长点！	1
最新股东人数是多少？	最新的股东人数是多少？	1
请问公司到9月30日，公司在手定单是多少？公司的产能利用率超过100%100吗？	请问公司要在9月30日前订购多少？公司产能利用率是否超过100%？	1
董秘你好，请问截止11月30日股东人数，谢谢。	董秘你好。你能告诉我截至11月30日的股东人数吗？谢谢。	1
请问，截止10月30日，公司股东人数？机构数？谢谢！	告辞了。到10月30日，公司股东人数是多少？有几个机构？谢谢。	1
您好！请问贵公司在行业是出于什么地位？市场占有率有多少？公司未来发展是通过抢占其它公司市场占有率？还以创新拓展新业务？还是通过资本扩张兼并优质同行业公司以及上游软件等公司？	你好！贵公司在行业中的地位是什么？市场占有率是多少？公司未来的发展是通过抢夺其他公司的市场份额吗？通过创新来开展新业务吗？还是通过资本扩张，收购同行业的优质公司和上游软件公司？	1
公司2021年财报有显著增涨，但股价下行幅度较大，请问2022年继续增加是否有遇到很大难度？ 公司是否可以报告投资人准备采用何种策略来保持公司稳定发展，防止业绩大起大落。是否考虑回购股份维持合理市值。另外建议公司采取一些更积进的发展策略而不是保守策略，危机也会产生很多机遇。	该公司在2021年财报中大幅增加，但股价大跌。在2022年添加代码是不是很难？公司是否可以报告投资者采取了哪些策略来维持公司的稳定发展，防止业绩起伏。是否考虑回购股票以维持合理的市值？此外，建议企业采取更进步的发展战略，而不是保守的战略，危机也将创造更多的机会。	1
5G高速发展，车联网，物联网，万物互联也是飞速发展，公司作为切入物联网的智能制造企业，是否有研发身边万物互联的核心模块：无线通讯模组？对无线通信模组的行业发展，是否有战略切入或扩大计划？	随着5G的快速发展，物联网也在快速发展。作为一家适合物联网的智能制造企业，公司是否拥有物联网的核心模块：无线通信模块？无线通信模块行业的发展有没有战略性的切入或扩展计划？	1
董秘你好,新闻报道公司有参加2021年珠海航展，请问是否有涉及军工业务？谢谢！	你好，董秘。新闻报道公司参加了2021年珠海航空展。它是否与军事业务有关？谢谢。	1
请问到10.20股东人数是多少	股东人数不超过10.20人有多少？	1
请问公司有什么优势能成为2022年北京冬奥会的特许生产商和销售商？	该公司能成为2022年北京冬奥会专利制造商和经销商有哪些好处？	1
您好，我是贵公司持股股民，公司地处浙江杭州，请问公司有参与杭州亚运会建设吗？浙江共同富裕示范区建设是否给公司业务带来提振效果？	抱歉，我是贵公司的股东。公司位于浙江省杭州市，公司是否参与杭州亚运会的建设？浙江共同富裕示范区的建设对公司业务有激活作用吗？	1
董秘好，请问公司产品在航空航天领域具体有哪些可应用领域及已有应用案例？	董秘，公司产品在航天领域有哪些具体的应用领域和现有的应用案例？	1
新国脉是贵公司控股上市公司，毫无核心技术亮点，业绩今年来一直亏损，作为控股股东是否对新国脉进行吸并整合，目前而言新国脉在电信业务中扮演什么角色，未来盈利模式是否期待向高科技服务方面转换。	新国脉是贵公司控股的上市公司，没有核心技术亮点，今年业绩一直亏损。作为控股股东，是否吸收整合了新的国脉？新国脉目前在电信业务中扮演着怎样的角色？未来的盈利模式能否有望向高技术服务业转型？	1
董秘好，我是贵公司的一名长期投资者，请问贵公司，截至2021年11月15日，公司的股东数是多少？谢谢！	董秘，我是贵公司的长期投资者。截至2021年11月15日，贵公司股东数量是多少？谢谢。	1
近几个月铁锂电池装车已远超三元，请问公司对高镍的前景怎么看？技术路线转变对公司未来的产能利用率有没有影响？谢谢	近年来，铁锂电池的负载量已经远远超过3元。该公司对高镍的前景有何看法？技术路线的改变是否对公司未来的产能利用率有影响？谢谢你，谢谢	1
董秘您好,请问氢动力轮椅研究得如何了?	董秘，您好。氢轮椅的研究是怎样的？	1
请问，截至2022年7月8日，公司的股东数是多少？谢谢	请问到2022年7月8日，该公司的股东数量是多少？谢谢你，谢谢	1
请问公司的产品，与阿兹夫定有何实质关系？公司的尿苷在应对新冠疫情方面有何作用？	请问该公司的产品与阿兹武定的真正关系是什么？该公司的尿苷在应对新冠肺炎流行方面发挥了哪些作用？	1
南通招商蛇口开发的滨江道项目，华发股份有没有参股呀？权益比例多少？	南通吸引蛇口开发的滨江路项目，有华发股份参与吗？股票的比例是多少？	1
董秘您好！公司三氯化磷年产量多少吨？谢谢！	董秘你好。这家公司的年产量三氯化磷有多少吨？谢谢。	1
请问11月10日股东人数是多少？谢谢！	11月10日的股东数量是多少？谢谢。	1
董秘你好，截止2021年12月15日贵公司股东户数是多少，谢谢！	你好，董秘。截至2021年12月15日，贵公司股东数量是多少？谢谢。	1
请问公司新能源车是否使用车载充电机	该公司是否在新能源汽车上使用车载充电器？	1
数字人民币App试点版正式上线，请问贵司是否有数字人民币方面的技术储备？有无相关的场景应用商业合作案例？	数字人民币App试点版正式上线。贵公司是否有数字人民币的技术储备？是否有适用商业合作案例的相关场景？	1
众所周知，歪果仁对户外电源的需求一直很旺盛。地广人稀的人口分布，野营、蹦极、漂流等户外运动都有足够的施展空间。就算在疫情当下，仍阻挡不住他们走出家门的脚步。贵公司有户外电源产品吗，哪里可以购买？	众所周知，外国人对室外电源需求旺盛。因为人口很少，所以有足够的空间去做露营、蹦极和漂流等户外运动。即使在疫情发生的瞬间，也无法防止他们走出家门。贵公司有室外电力产品吗？在哪儿能买到那些？	1
请问贵公司截止今天股东人数多少？	到今天为止，你们公司的股东人数是多少人？	1
请告知截止到1月20日，最新股东人数，谢谢！	请告诉我截至1月20日的最新股东人数。谢谢。	1
春雪迎春系列食材是你们公司的产品吗？	春雪迎春系列的配料都是贵公司的产品吗？	1
请问，截至2022年三月 18日公司的股东总数是多少？谢谢	请问到2022年3月18日，公司股东总数是多少？谢谢你，谢谢	1
您好，请问截止1月10日最新的股东人数是多少？望告知一下，谢谢	您好，到1月10日，最新的股东人数是多少？请告诉我。谢谢。	1
你好董秘  公司产品有应用于核电领域吗？	请问董秘的产品是用于核电领域的吗？	1
公司主营业务不是电力和电煤的经营吗，为什么会被划归为批发业而不是电力？	该公司的主营业务不是电力或动力煤，为何被归类为批发而非电力？	1
截止到2021年11月30日股东人数是多少？多谢回复！	到2021年11月30日，股东人数是多少？谢谢您的回复！	1
董秘你好，贵公司业务是否涉及军工产品，有无此方面的发展规划？谢谢	请问董秘，你的业务涉及军工产品吗？你在这方面有什么发展计划？谢谢你，谢谢	1
董秘您好！时速600公里磁悬浮高铁列车通长部件焊接技术及国内首台600吨惯性摩擦焊机已研制成功，均走在世界前列，不但解决国内“卡脖子”、“补短板”的关键焊接技术难题、替代进口，还丰富了产品构成，拓宽了企业发展路径。请问是贵公司研发的产品吗？	董秘你好。时速600公里磁浮高速列车贯通件焊接技术和我国首台600吨惯性摩擦焊机研制成功，均走在世界前列。它不仅解决了国内“卡脖子”、“短短板”焊接关键技术难题，丰富了产品构成，拓宽了企业发展路径。请问这是贵公司开发的产品吗？	1
亚盛饮马分公司是不是生产肉牛？	亚生水马分公司有肉牛吗？	1
董秘好，公司是否有机器人相关产品出售，具体为那些智能产品？公司是否有新能源汽车相关产品？主要客户有哪些？	董美，公司有卖机器人相关的产品吗？特别是有那些智能产品吗？那家公司有新能源汽车相关的产品吗？主要客户是什么？	1
现在是否有医院已下订单或者有意向订单？	有订购的医院或预定订购的医院吗？	1
尊敬的董秘你好，请问贵公司在沪深两市上市公司中有无同类型产品的竞争对手？市场占有率是多少？谢谢	请问董秘，沪深两市上市公司中是否有同类产品的竞争对手？市场占有率是多少？谢谢你，谢谢	1
中一签未抛，深度被套。请问咱们公司有光伏逆变器技术和产品么？IGBT	第一场胜利不是投的，深度是平局。我们公司有光伏逆变器技术和产品吗？IGBT，IGBT	1
公司有否考虑制作一款中国的元宇宙足球游戏？	该公司有没有考虑过制作中国梅塔巴斯的足球游戏？	1
金龙鱼与今年年中收购了广东广味源调味品公司，目前在广味源线上以及线下渠道售卖的产品收入纳入金龙鱼财报么？非常感谢。	金龙鱼和今年年中收购的广东广味源调味品公司，目前在广味源在线线下线下销售的产品收入是否已进入金龙鱼结算？非常感谢。	1
为增加投资者信心，恳请贵公司回购股票，谢谢。	为了增强投资者信心，我们敦促贵公司回购股票。谢谢。	1
您好，截至2021年11月19日，公司股东人数是多少？谢谢	您好，截至2021年11月19日，股东人数是多少？谢谢你，谢谢	1
董秘你好，请问截止到11月10日，华利集团股东人数是多少呀？谢谢	董秘，您好，到11月10日，华立集团的股东人数是多少？谢谢你，谢谢	1
你好，请问懂秘，9月10月甘源是否限电，对产能是否有影响，及交货周期。河南工厂之前调研说四季度投产，请问现在是否投产，谢谢	我想问一下秘诀，请问9月10月有姜源限电吗？产能、交货周期是否有影响。这家位于河南的工厂表示，它已在第四季度开始生产。你想知道那个现在是否生产吗？谢谢。	1
请问贵公司在手订单还能生产多久？有新的大订单吗？	请问贵公司手头的订单能生产多少？有新的大订单吗？	1
董秘你好，公司目前战略合作了多少家房企，另公司招标项目中有多少份额来自于战略招标。	请问董秘，公司目前有多少家房地产企业在进行战略合作？公司的招标项目有多少份额来自战略竞争价格？	1
董秘，您好，请问截止2021年11月10日咱们的股东户数是多少？谢谢。	董秘，您好，到2021年11月10日，我们的股东户数是多少？谢谢。	1
你好截止4月20股东人数是多少	您好，到4月20日的股东人数是多少？	1
董秘你好！ 请问贵公司就  国家发改委关于《“十四五”冷链物流发展规划》《“十四五”国家骨干冷链物流基地建设实施方案》《关于推动冷链物流高质量发展 助力构建新发展格局的意见》等方面是否有相关配套规划？谢谢！	你好，董秘！贵公司对国家发改委“十四五规划”、“国家骨干冷链物流基地建设实施方案”、“关于推动冷链物流高质量发展构建发展新格局的意见”等是否有相关配套规划？谢谢。	1
董秘你好，请问公司今年以来的合同订单如何？是否较往年有很大的增长？	董秘你好。到今年为止，该公司的合同订单有哪些？比几年前长得大吗？	1
上次董秘回答司正在推动碳纤维、麻纤维等新材料应用技术，迎合未来汽车轻量化的发展趋势。请问，目前炭纤维 麻纤维新材料都有哪些技术储备或者专利。	上一次，董秘回应称，公司推广碳纤维、大麻纤维等新材料的应用，以迎合未来汽车轻量化的发展趋势。请问目前碳纤维和大麻纤维新材料的技术储备或专利有哪些？	1
请问贵公司如何抓住欧洲的冬季消费市场？最近欧洲的家纺订单是否有所增加？	贵公司如何占领欧洲冬季消费市场？最近欧洲的家纺订单增加了吗？	1
请问到目前公司股东人数是多少？股东是否有减持意向？谢谢	到目前为止，该公司的股东数量是多少？股东是否有意减持？谢谢你，谢谢	1
利用深度学习算法，人工神经网络可以接受大量显微镜图像数据集的训练，通过这些图像，它可以学习识别新冠病毒特征模式。训练和验证完成后，神经网络便可自动检测体液中新冠病毒。请问公司是否具备研发全自动新冠病毒检测显微镜的能力？	使用深度算法，人工神经网络可以在大量的显微图像数据集进行训练，通过这些图像，可以学习识别新的冠状病毒特征模式。经过训练和验证，该神经网络可以自动检测体液中的新型冠状病毒。该公司是否有能力开发全自动新型冠状病毒检测显微镜？	1
请问公司航展参展产品有哪些呢？	参加航空展的公司有什么产品？	1
请问公司年报里面显示的经营管理人员 1425人，业务职能人员是1167 现场运行及支持人员 1974人 请问核电站是否考虑优化一下？有优化的空间？随着公司经营效率提高，公司是否考虑提升一下人均产能？通过技术提高 降低人数	请问公司年报显示，公司运营管理人员1425人，业务功能人员1167人，现场驾驶辅助人员1974人，核电是否考虑优化？有优化的余地吗？随着公司经营效率的提高，公司是否考虑提高人均运力？因技术改良而减少人员	1
加密数字货币是使用密码算法的数字货币，最主要的几大特性是去中心化、加密解密技术、区块链技术、共识机制等；吉大正元主营业务是以密码技术为核心，开展信息安全产品的研发、生产和销售及服务。请问，公司的股票，目前为什么没有数字货币概念？谢谢！	加密数字货币是一种使用加密算法的数字货币，其主要特点是去中心化、解密技术、区块链技术、共识机制等。吉大正元的主要业务是基于密码技术。开展信息安全产品的研发、生产、销售和服务。请问这家公司的股票，为什么没有数字货币的概念呢？谢谢。	1
贵司今年酒类产品销售额占比多少？	贵公司今年的白酒销售额占多大比例？	1
您好，公司的产品是否可以服务于元宇宙相关企业的应用场景？谢谢	您好，该公司的产品可以服务于梅塔巴斯相关企业的应用场景吗？谢谢你，谢谢	1
请问公司截止目前股东人数是多少，谢谢您的回复。	到目前为止，该公司的股东数量是多少？谢谢您的回信。	1
贵公司生产车载摄像头吗？销量怎样？	你们公司生产车载摄像头吗？销售情况如何？	1
董秘好  请问贵司最近有没有新的订单？或者项目最近是否有新的进展？谢谢	董米浩，最近有新订单吗？或者，这个项目最近有了新进展吗？谢谢你，谢谢	1
智暖岩板是保温产品，还是发热产品？	知温岩板是隔热产品吗？还是暖气产品？	1
请问董秘 该公司财务数据净利润增长1倍左右，请问利润主要来源为国防军工订单还是口罩无技术含量订单。 是否涉嫌财务造假	对不起，董秘，公司财务数据净利润增长了100%左右。请问利润主要来自国防军工订单，还是口罩非技术含量订单？它是否涉嫌财务欺诈？	1
公司称“募投项目30万吨/年有机硅单体及20万吨/年有机硅下游产品目前相关手续正在办理当中”近期股价迎来继续暴跌，是否办理手续在审批不能通过？	该公司表示，“30万吨/年有机硅单体和200000吨/年有机硅下游产品目前正在办理相关手续。”最近股价持续暴跌，手续不能批准吗？	1
你好！请问下贵公司股东有多少人？	你好！请问贵公司有多少股东？	1
请问元月10日股东人数？	我可以问一下1月10日的股东数量吗？	1
请问一下株洲高科减持了没有	请问株洲高新减股了吗？	1
您好，请问，贵公司截止12月31日股东人数是多少？谢谢！	请问到12月31日，你们公司的股东人数是多少？谢谢。	1
董秘你好！贵司25日晚间公告称：转让津荣中和超一半的股权，研读公告，前三季度该子公司净利润仅16.29万，企业进一步减负，可喜可贺！另企业在环上海经济圈（苏州及湖州）投资成立津荣子公司主营产品主要为哪方面？	你好，董秘！贵公司25日晚间公告：向锦荣众转让一半股权，经研究公告，前三季度子公司净利润为162900，企业再负，恭喜！此外，金荣子公司投资上海经济圈(苏州、湖州)企业的主要产品有哪些？	1
请问贵公司的铝合金压铸里有一体压铸这项技术吗？另外在汽车热管理方面有何储备或涉猎？谢谢。	你们的铝合金压铸有完整的压铸工艺吗？此外，你有没有关于汽车热管理的储备或脚？谢谢。	1
董秘您好，是否考虑改名：联泓新材	董秘，您好，要考虑改名吗？是联宏新材吗？	1
你好，周末汤加的火山喷发，让全球的大气层受到极大污染，公司有产品运用于大气污染治理的吗？	您好，上周末汤加火山喷发对全球大气造成了严重污染。这家公司有什么空气污染控制产品吗？	1
请问公司产品主要应用在哪些行业中？	那家公司的产品主要用于什么行业？	1
请问子公司百斯医学取得五项新冠病毒产品的欧盟 CE 认证，包括抗原、抗体检测，是否属实？	请问子公司百世医药获得了包括抗原和抗体检测在内的新型冠状病毒产品的5项欧盟CE认证，是真的吗？	1
董秘您好，近日，生态环境部发布了长江流域总磷污染控制方案。贵公司作为一家环保企业，在对磷化工企业生产过程中产生的废气、粉尘、废水等污染物有无针对性的产品设备及治污方案？	你好，董秘。近日，生态环境部印发了长江流域总磷污染治理方案。作为环保企业，贵公司对磷化工企业生产过程中产生的废气、粉尘、废水等污染物有针对性的产品、设备和污染治理方案吗？	1
董秘好，请问截止目前股东人数多少？谢谢	董秘，到目前为止股东人数是多少？谢谢你，谢谢	1
董秘，您好，请问法本信息在业务上是否与华为及鸿蒙有战略合作关系？	董秘您好，您和华为、鸿蒙在业务上有战略合作关系吗？	1
请问公司是华为的客户吗？	该公司是华为的客户吗？	1
请问一下 我们公司的产品为什么定位是处方药！而不是保健品	请问为什么我们公司的产品定位为处方药呢？不是保健品。	1
请问贵公司产品涉及国家药品集采吗？	告辞了。你们的产品与国药有关吗？	1
请问公司产品是否应用于逆变器和工业机器人上面？谢谢	该公司的产品是否用于逆变器或工业机器人？谢谢你，谢谢	1
截止11月26号收盘的股东人数是多少？	到11月26日，被关闭的股东人数是多少？	1
请问公司副总经理、核心技术人员陈启峰离职对公司的影响？南土资产举牌公司的股票后是不是有限售期，在一定时间内不可以卖出股票。公司10月份以来产能利用率怎么样。	公司副总经理、核心技术人员陈启峰的离职有何影响？南图资产公司股份的出售是否有期限，不得在一段时间内出售股份。该公司10月份以来的产能利用率是多少？	1
你好 请问截至11月10日公司股东人数是多少？谢谢	请问到11月10日，公司股东人数是多少？谢谢你，谢谢	1
公司是特斯拉的直接供应商还是间接供应商？谢谢	该公司是特斯拉的直接供应商还是间接供应商？谢谢你，谢谢	1
董秘你好！请问贵公司是否有土壤修复的项目或业务？	你好，董秘！贵公司有什么土壤修复项目或业务吗？	1
懂秘您好？贵公司设备可以用在第三代半导体碳化硅方面吗？	你好，你还好吗？你们的设备可以用在第三代半导体碳化硅上吗？	1
请问公司产品是否应用医疗行业，国家这几年对医疗垃圾处理同样重视，公司的产品是否有应用医疗行业	请问该公司的产品是否应用于医疗行业，国家近年来对医疗废物处理给予同等重视，请告诉我们该公司的产品是否应用于医疗行业。	1
董秘你好，公司产品贯穿公司客户从研究到应用的全过程，那么请问公司是否与开发、研究元宇宙的公司有合作？	您好，董秘，公司的产品，打通了企业客户从研究到应用的全过程，企业是否与研究梅德巴斯的研发公司合作？	1
董秘您好！请问近期纺机出口欧洲订单是否增加了？	董秘你好。最近出口到欧洲的纺织机械的订单增加了吗？	1
在汽车消费电子以及新能源领域，公司是否有进一步拓展市场份额的计划？	该公司是否有计划进一步扩大其在汽车、消费电子和新能源领域的市场份额？	1
新希望3月16日发布通知，虾蟹饲料涨价300元一吨，请问公司的产品是否同步涨价？同时阿根廷禁止出口豆粕豆油，很可能推动原料涨价，公司是否做好了充足的原料储备？	3月16日，新希望发布公告，宣布将虾蟹饲料价格每吨上调300元。公司产品的价格是不是也同步上涨了？与此同时，阿根廷对豆粕和豆油的出口禁令可能推高原材料的价格。公司有足够的原材料储备吗？	1
请问公司是否有元宇宙+室外大屏的技术储备和产品方案？谢谢！	公司是否有远太空+室外大屏幕的技术储备和产品方案？谢谢。	1
请公开8月30股东人数谢谢	请在8月30日披露股东人数。谢谢。	1
你好董秘，贵公司目前的产品是否实现国产替代？贵公司在安徽省内是否属于行业龙头企业？	请问董秘，请问贵公司目前的产品实现了国内替代吗？贵公司是安徽省的龙头企业吗？	1
董秘您好，贵司是否有大的扩产规划，现在同行通威股份明年产能扩张到20万吨以上，2023年产能不低于38万吨，保利协鑫也规划到明年底产能到顶30万吨，贵司如果还是保持现在产能将远远落后同行，请问是否有其它的发展战略	董秘先生，请问贵公司有没有大的扩容计划？目前，同业通威股份产能明年将扩大至200000吨以上，2023年不低于380000吨。保利协鑫还计划在明年底前拥有30万吨产能。如果你的公司保持着目前的产能，它将远远落后于同行。有没有其他的发展战略？	1
公司在海外的经销网点有多少家？及未来在海外的发展战略？	那家公司有多少个海外分销网站？那么未来的海外发展战略又如何呢？	1
请转告那2家减持股份的机构投资者抓紧减持！谢谢!	请转告减持的两家机构投资者尽快减持！谢谢。	1
尊敬的董秘，请问截止到11月30日，有多少股东？	尊敬的董秘，到11月30日，有多少股东？	1
您好！贵司收购的松下标的是否有空气热能汞相关技术专利？	你好！贵公司收购的松下标的中是否有关于空气热汞的专利？	1
请问，公司在航空部件、汽车配件两方面有哪些产品？占比多少？	告辞了。这家公司有什么航空零部件和汽车零部件的产品？百分率是多少？	1
贵公司与宇信科技的合作有什么突破吗？有什么案例或者产品了吗	你与宇信技术的合作被突破了吗？有盒子或产品吗？	1
贵公司在数字货币以及支付方面，是否有业务？业务量大概多少	贵公司有数字货币和支付业务吗？大概的业务量是多少？	1
董秘好，贵司半年度业绩大增，却上市当天就破发，堪称最差上市公司，是因为预期下半年业绩不行了吗？请董秘正面回复一下在手订单状况如何，下半年业绩能否保持持续增长？	董的秘诀是好事，贵公司业绩半年就大幅增长，但上市当天就破了，最糟糕的上市公司，下半年业绩预期是不是不合格？关于手头订单的情况，以及下半年的表现是否持续增长，请给予积极的回答。	1
董秘：在历史性的发展机遇面前，贵公司是否有产业升级，进入车规级产品的规划？	董秘：面对历史性的发展机遇，贵公司有什么产业升级、进入军车规级产品的计划吗？	1
下次解禁什么时候	下一次解禁时间是什么时候？	1
贵司在碳交易方面有无战略布局？	贵公司在碳交易上有战略布局吗？	1
你好，麻烦提供一下最新一期股东人数，谢谢	您好，请提供最新的股东数量。谢谢。	1
董秘您好！贵公司产品是否可以应用到军工、航空航天领域（请简单明了的回复）？谢谢！	董秘你好。你们的产品能否应用于军工、航天等领域(请简单易懂地回复)？谢谢。	1
董秘你好，贵公司跟合肥城建有战略合作吗！！！！	请问董秘，贵公司与合肥城建设是否有战略合作？	1
公司跟客户有没有展开在数字人民币应用场景领域业务合作？ “有”还是“没有”？ 简单回复就行，不涉密。谢谢	公司与客户在数字人民币应用场景领域有业务合作吗？是“是”还是“不”？只是简单地回答，不包含任何秘密。谢谢你，谢谢	1
董秘你好，关于贵司聘请张聿先生为北中网科技荣誉顾问，聘请谢丹先生为北中网科技专家顾问，请问张聿先生、谢丹先生两位业内大佬的加入是否为贵司引入新的战略投资者？	你好，董秘。关于贵公司聘请张魁先生担任科技名誉顾问、担任谢丹先生担任科技专家顾问一事，张先生和谢丹两位行业领袖的参与会不会为贵公司引入新的战略投资者？	1
请问贵公司有生产卡龙酸酐产品吗？	你们公司生产碳酸酐吗？	1
公司产品有销往欧洲吗？	那家公司的产品销往欧洲吗？	1
首先祝贺公司成功科创板上市,看了下公司主营业务是发动机的零部件,想请教下,新能源车逐步替代燃油车的大趋势下,会不会对公司主营业务造成影响,因为新能源车发是用电机的,不是发动机。公司面对这种环境,是否有相应对策,谢谢。	首先，祝贺公司科创板成功挂牌。我看到该公司的主要业务是发动机部件。请问新能源汽车取代燃油汽车的大趋势会影响公司的主营业务吗？因为新能源汽车是由发动机驱动的，而不是发动机。面对这样的环境，感谢公司是否有相应的应对措施。	1
公司目前跟踪的GIL订单有哪些，总共多少公里，预计都在哪些时候落地	该公司目前追踪的GIL订单有哪些？一共有多少公斤？你打算什么时候着陆？	1
年中报披露公司募投项目，投资进度在50—60%即已达到预定可使用状态，请问为什么可以提早这么多开始使用设备？产能是否已经达到原定募投产能？	年度报告显示，该公司的筹资项目已经达到预期的可用状态，投资进度为50%。为什么这么快就能使用这些设备？产能是否达到原先计划的产能？	1
请问贵公司生产的半导体硅片的硅料是进口的吗？主要供应商是哪家?有没有国产替代化方案，是否有被制裁的风险?  请分别认真回答以上问题，谢谢。祝公司蒸蒸日上，市值早日破千亿。	请问贵公司生产的半导体晶圆硅材料是进口的吗？主要的供应商是哪个？国内还有其他选择吗？有被制裁的风险吗？请认真回答以上问题。谢谢。祝愿公司早日繁荣，市值突破千亿元。	1
您好，请问后期6GWh的产能如何规划，电动二轮车需求疲软下主要增长点在哪里呢？在现有产能都没有满产的情况下如何消化掉这些产能呢？	请问后期如何规划6GWh产能，如果电动两轮车需求疲软，主要增长点在哪里？当现有容量不足时如何消化？	1
别人家的公司增持的增持，回购的回购，贵公司难道不懂市值管理的重要性吗？	你不明白别人公司增持回购时市值管理的重要性吗？	1
请问目前公司订单充足吗？	公司目前是否有足够的订单？	1
公司的尿苷产品是默沙东莫努匹拉韦新冠特效药的医药中间体，说明公司有雄厚的新冠特效药相关技术储备。并且默沙东已经同意全球100多个国家对莫努匹拉韦进行仿制，难道公司就没有考虑加入仿制的行列吗？？	该公司尿苷产品为莫沙酮莫努培拉韦新冠肺炎特效药的医药中间体，表明公司拥有较强的新冠肺炎特效药相关技术储备。玛莎东同意在全球100多个国家复制独木大楼，该公司难道不考虑参与模仿吗？	1
董秘你好：一季度薪火相传的销售额是多少啊？	你好，董秘：第一季度的销售额是多少？	1
公司订单量如何？	这家公司的订单量是多少？	1
董秘你好，公司有无设备或产品，参与央视春晚或者各大地方春晚节目录制使用。谢谢！	您好，董秘，公司有没有参与录制央视春晚或当地春晚节目的设备或产品？谢谢。	1
公司的氢燃料发动机什么时候量产？	该公司的氢发动机什么时候量产？	1
希望贵公司加强管理，做好生产工作，并积极推进新项目进展，创造价值，给广大中小股东以应有收益。2021年上半年已接近尾声，请问贵公司给我们分享一下上半年华南市场mtbe及异辛烷行情如何及公司下半年的展望。	希望贵公司加强管理，掌握生产，积极推进新项目进度，创造价值，使广大中小股东受益可观。2021年上半年已接近尾声。请分享上半年南方中国地区甲基叔丁基醚和异辛烷的市场状况及公司下半年展望。	1
董秘您好，我想问一下公司的中间体，PA0072、PA0244、PA0152、PA5771是否量产了？另外方便公布一下PA0045、PA5437、PA6764、PA1725、PA6990的在手订单情况吗？	董秘，您好。请问该公司的中间体PA0072、PA0244、PA0152和PA5771是否已经量产？此外，PA0045，PA5437，PA6764，PA1725，PA6990现有订单的发布容易吗？	1
贵公司在HIT电池方面有没有相关产品,或者将来有没有相关产品的生产计划?	贵公司是否有HIT电池相关产品，或者未来是否有相关产品的生产计划？	1
希望董秘不要回避问题，光明食品集团是否报名作为战略投资者参与科迪集团重整？科迪集团实控人是否有意向引进光明食品集团？建议大股东务必引入光明食品集团等有实力的战略投资者。	我希望董事长不要回避这个问题。光明食品集团是否以战略投资者身份签署参与科迪集团重组的合同？科迪集团的控制者是否打算引入光明食品集团？建议大股东必须引入光明食品集团等实力雄厚的战略投资者。	1
请问公司充电桩业务发展怎么样？	公司充电桩业务发展情况如何？	1
董秘 你好：      想了解下，贵司对未来有什么发展规划，对现有产品门类在技术上或者投入上有新的设想吗？在科技兴邦，制造业兴国的大背景下，贵司是否有投入前瞻性或者针对国外垄断性替代产品的相关可行性计划。	请问董秘：你想知道贵公司对将来有何发展计划吗？在技术和投资方面，对现有产品类别有什么新的想法吗？在科教兴国、制造业兴国背景下，贵公司有什么可行的投资前瞻性或国外垄断替代产品的计划吗？	1
董秘你好，请问若铁牛集团质押的股票拍卖成功，是否还是限售股?	董秘你好。如果铁牛集团质押的股份成功拍卖，还会成为限售股吗？	1
请问公司是一家元宇宙基础设施供应商吗？请回答是还是不是就可以	该公司是梅塔巴斯的基础设施供应商吗？请回答“是”或“否”。	1
你好董秘，贵公司与比亚迪合作哪一方面的业务，具体提供的产能是多少。	请问董秘，贵公司与比亚迪合作的是哪些业务？提供了多少运力？	1
请问公司的技术研发主要是靠内部还是外部？外部的话是否与电池厂商或整车厂商有共同研发（如果有共同研发就可以在研发阶段就锁定未来的产能订单）？是否与第三方的科研机构等有长期紧密的合作？	请问该公司的技术开发主要依赖内部还是外部？外部是否与电池制造商或整车制造商有联合开发(如果有联合研发，可以在研发阶段确定未来产能的订单)。您是否与第三方研究机构有长期密切的合作？	1
董秘你好，现在智能家居作为一大发展趋势，我见公司有扫地机器人，吸尘机等相关智能家居用品，且对标科沃斯石头和戴森，感觉公司可以将智能家居作为一大发展方向，凭借公司本身研发优势，供应链优势，应将智能家居作为重点战略发展。	您好，董秘，目前智能家居作为一大发展趋势，我看到公司有扫地机器人、吸尘器等相关智能家居产品，但到了标准科沃斯和戴森，我觉得公司可以把智能家居作为一个大的发展方向。凭借公司自身的研发优势、供应链优势，智能家居应该是战略发展的重点。	1
请问贵公司2015年1.5亿投资的香港医思医疗现在还持有多少股份？	2015年贵公司以1.5亿元投资的香港医药股份有限公司，如今拥有多少股份？	1
公司怎么看待海天味业产品的涨价？公司会和海天味业一样涨价来对冲原材料的上涨吗？	该公司如何看待海天香料产品的涨价？该公司会不会像海天香精一样提高价格，对冲原材料价格的上涨？	1
董秘好： 关于新产品方面，交流伺服L8系列产品目前市场反馈如何，大致什么时间能有批量订单进展？ PLC产品今年进展情况怎么样，是否有规模化市场进展？	董米浩：关于新产品，目前交流伺服L8系列产品的市场反馈如何？什么时候批量订单会有进展？今年PLC产品进展如何？大型市场有进展吗？	1
董秘，请问今年有新车上市销售吗？	董秘，今年新车上市了吗？	1
董秘，你好，请问公司产品是否可用于新一代人工智能示范应用场景？谢谢	请问董秘，公司的产品可以用于新一代人工智能的示范应用场景吗？谢谢你，谢谢	1
请问最近纸浆涨价对公司成本有多大影响？公司是否采取措施应对纸浆涨价？	最近纸浆价格的上涨会对公司成本产生怎样的影响？该公司是否应对纸浆价格上涨？	1
请问公司产品是否有元宇宙概念？	该公司的产品有元巴斯的概念吗？	1
公司账上有大量现金，有没有考虑过增持或分红及研发。	这家公司的账户里有很多现金。你是否考虑过股息的增资或研发？	1
请问公司止12月20日或12月10日股东户数多少？谢谢！	到12月20日或12月10日，该公司的股东家族数量是多少？谢谢。	1
公司大股东减持半年，时间到期后又开始减持，投资者都很愤怒，现在早已跌破发行价，由于当初承诺，跌破发行价后就不再减持，公司大股东是否能公告，由于现在的状况，不适合再减持，终止减持行为。公司的老总为了维护股价，是否协调相关股东，不再进持减持。	公司大股东减持半年，到期后再度开始减持。投资者很生气，现在已经跌破了发行价。根据当初的承诺，跌破发行价后将不再减产。公司大股东可否公告称，考虑到目前情况，不应再次停止减持、停止减持？公司总经理为了维持股价，是否调整相关股东，不再减息。	1
董秘您好， 请问现有A股股东数多少？ （披露当前A股股东数目并不违规，您选择不回答的话，请给个理由。而不是外交辞令一样的，说什么定期报告会披露。 不回答这个问题，要么表示您对股东并不尊重，要么表明公司并不想公布股东数目背后可以有阴谋论。	董秘先生，请问A股的股东人数是多少？(目前披露A股股东数量并不违法。如果你选择不回答，请告诉我理由。据悉，与外交辞令不同的是，定期报告将被披露。不回答这个问题，要么意味着不尊重股东，要么意味着公司不愿透露股东数量，背后可能有阴谋论。	1
请问一下大股东嘉兴目前减持情况？	请问大股东嘉兴目前减息情况如何？	1
董秘你好，请问公司有没有edr相关产品	请问董秘，公司有EDR相关产品吗？	1
请问公司目前订单量如何，工厂负载如何，是否满产？	该公司目前的订单量是多少，工厂负荷如何，满负荷生产？	1
近期德国发生的三起户用储能火灾与公司有关系吗？涉事供应商是公司客户吗？	德国最近发生的三起家庭储存火灾是否与该公司有关？相关的供应商是公司的客户吗？	1
请问，公司产品氯化铝产能是多少？现阶段产量是多少？这几天传说铝电池，公司有没有打算扩大产能？	请问氯化铝的生产能力是多少？现阶段的产量是多少？最近几天有人说铝电池，公司有没有计划扩大产能？	1
董秘您好！贵公司在BIPV，即光伏建筑一体化领域中是否有业务布局？麻烦您介绍一下，感谢！	董秘你好。贵公司在BIPV领域，即光伏建筑一体化方面是否有业务布局？能给我介绍一下吗？谢谢。	1
请问公司在阿富汗是否有业务？未来是否计划在阿富汗开展矿产业务？	该公司在阿富汗有业务吗？你有计划将来在阿富汗做矿物生意吗？	1
公司是否向小米，华为，oppo等公司供应产品，公司产品是否应用于智能电表，充电桩，新能源快充等产业？	该公司是否为小米、华为、OPPO等公司供应产品？我们的产品是否用于智能电表、充电桩、新能源快速充电等行业？	1
￼ ￼ ￼ ￼ ￼ ￼ ￼ 尊敬的董秘您好！请问11月20日公司股东人数多少？谢谢！ ￼	尊敬的董秘先生您好。11月20日，该公司的股东数量是多少？谢谢。Cumbal：Cumbal	1
尊敬的贵司董秘，请问贵司有不有与数字货币相关的业务以及相关技术储备？	尊敬的董秘，是否有数字货币相关业务和相关技术储备？	1
董秘您好！新闻报道贵公司的分散染料已全部停产，请问是否属实？	董秘你好。据报纸报道，你们所有的分散染料都已停止生产。这是真的吗？	1
董秘你好，关注到贵公司回复卡龙酸酐为OEM产品。查询到同行泰坦科技公司所有产品均为OEM，其说明是：提供核心技术以设计和研发产品，OEM厂商进行代工生产。 请问公司是否也是如此，提供卡龙酸酐的核心技术以设计和研发，OEM厂商进行代工生产？	你好，董秘。我担心贵公司回复了碳酸酐的OEM产品。向同行介绍泰坦科技公司的所有产品为OEM，其描述为：提供核心技术来设计和开发产品，OEM制造商用于OEM生产。请问公司是不是一样？为设计和研发提供核心技术的钾酐，是否为贴卡的厂家提供贴牌生产？	1
董秘您好，请问截止11月30日收盘的股东人数，谢谢，祝一切顺利！	董秘你好。请问11月30日收盘的股东人数是多少？谢谢。祝你一切顺利。	1
董秘，您好，最新发布的小米12是否有使用贵公司的产品，顺便问下A1今年能通过认证吗？	董秘您好，新发布的小米12用贵公司的产品吗？顺便问一下，A1今年可以通过认证吗？	1
公司有股权质押和商誉情况吗？风险是否可控	公司是否拥有股票质押和商业权？你能控制风险吗？	1
董秘你好，贵司供应商只有17家，是否要开拓一下，这样才能有效降低采购成本，谢谢！	对不起，董秘，贵公司只有17家供应商。希望开放，有效降低采购成本。谢谢。	1
请问12月20日股东人数	请问12月20日的股东人数是多少	1
公司在手订单有多少？	这家公司有多少订单？	1
公司系 Oculus 以及索尼的 VR 设备的结构性器件供应商。 请问Oculus 和Facebook什么关系，FB更改名字为Meta都公司产品，未来有什么提升和影响？	该公司是Oculus和索尼VR设备的结构设备供应商。Oculus和facebook之间有什么关系？FB更名为Meta Products。对未来会有怎样的促进和影响？	1
请问贵司近期是否有申请新的国家发明专利？	贵公司最近申请了新的国家发明专利吗？	1
请问一下，截止11月20日公司股东人数，谢谢。	告辞了。这是公司截至11月20日的股东人数。谢谢。	1
金螳螂三季报简报和所签订单迟迟不能发出，是否出现巨额坏账亏损和大比例下滑？	黄金螳螂三季报和合同订单无法发送，有没有巨额不良债权损失和大比例下降？	1
公司主营是正宗的EDR，为何东方财富网没有将贵公司收录？另外，公司相关业务订单近期有没有增加？	该公司的主要业务是正品EDR，为什么东方富网没有收录贵公司？此外，最近公司的相关业务订单是否有所增加？	1
董秘您好！结合我国《“十四五”智能制造发展规划》，《“十四五”机器人产业发展规划》，请问贵司的机器人制造、智能制造、智能制造系统解决方案服务能力在什么水平，市场占有率有多少，谢谢！	董秘你好。结合中国“智能制造发展第十四个五年规划”和“机器人产业发展第十四个五年规划”，您的机器人制造、智能制造和智能制造系统解决方案服务能力水平如何？市场占有率是多少？谢谢。	1
董秘你好！公司生产的预制菜各大商超销售火爆，春节临近产品的需求将大幅提升，公司有做好准备吗？公司产品除在国内畅消，有无开拓国外市场？	你好，董秘！该公司预制蔬菜销售盛行，临近春节的产品需求将大幅增加。公司准备好了吗？除了使公司产品在国内消费畅通外，公司是否开拓了海外市场？	1
董秘您好，公司引进战略投资者现在进展如何了？	董秘，您好，公司在引进战略投资者方面有何进展？	1
请问贵司，在去年及今年上半年是否存在因公司产能不足导致将相关订单委外生产的情况，若有，该项数据是多少（如风电塔筒、桩基的套数或者委外生产的金额）	请问贵公司有没有在去年和今年上半年因产能不足而将相关订单外包？如果有，数据是什么(例如风塔、桩基套数或合同产量)	1
贵公司林总的股票质押率，目前是否有爆仓危险？	贵公司林先生现在的股票抵押率有爆炸的危险吗？	1
你好，请问公司与自然资源部是公司的客户吗？合作的内容涉及到哪些方面？ 还有和一些地方资源局是不是也是贵公司的客户？	请问公司和自然资源部是公司的客户吗？合作涉及哪些方面？有些地方资源局也是贵公司的客户吗？	1
董秘你好，请问德州禹城封城对公司业务有多大影响呢目前的生产经营情况能大概说说吗停产了呢还是一切正常，望答复投资者非常关切公司状况	董秘你好。德克萨斯州禹城关闭对公司业务有多大影响？你能告诉我目前的生产经营状况吗？你们停止生产了吗？还是一切正常？投资者希望回答非常关注该公司的情况。	1
请问，截至2021年11月30日，公司的股东数是多少？12英寸硅片新增15万/月产能预计产能爬坡需要多长时间？目前硅片订单是否能消化新增产能？谢谢！	请问到2021年11月30日，该公司的股东数量是多少？12英寸硅片将产能提升到150000/月需要多长时间？目前的硅片订单能消化新增产能吗？谢谢。	1
目前在双碳大趋势，行业大量更换高效节能装备，公司的产品节能、高效、稳定，目前产能可以满足订单的增长吗？	目前，在双碳大趋势下，行业更换了大量高效节能设备，公司产品节能高效稳定。目前的产能能否满足订单的增长？	1
董秘，你好，之前你回复公司主营业务为树脂镜片、成镜、镜片原料等眼视光产品的研发、设计、生产和销售，想具体问下，公司所生产经营的范围或者材料是否可以运用在VR镜片上面，另外这边一直回复关注前瞻性内容，目前是否已关注并建立一定信息及技术？	董秘，您好，在回复之前，公司的主要业务是树脂镜片、成品镜片、镜片原材料等验光产品的研发、设计、生产和销售。具体想问一下，该公司的生产经营范围和材料是否可以用于VR镜头，另外，这一方关注的是前瞻性的内容，是不是关注一定的信息和技术而构建的？	1
懂秘你好，到7月11号止公司股东人数是多少？	您好，到7月11日，公司的股东数量是多少？	1
请问公司截止8月31日的股东人数是多少？谢谢！	截至8月31日，该公司的股东数量是多少？谢谢。	1
你好，请问贵公司是否有研发第三代半导体？	请问贵公司是研制第三代半导体的吗？	1
请问董秘，截止7月19号收盘，公司实际股东人数是多少？	请问董秘，截至7月19日收盘的公司实际股东人数是多少？	1
拜登新提出的制裁对贵司是否有影响，贵司是否会收缩业务，甚至面临退市	拜登提议的制裁措施会影响贵公司吗？贵公司是否会缩小业务，进一步面临退市？	1
董秘你好公司开发的氢储设备都有哪些客户在使用	你好，董秘。哪些客户使用该公司开发的储氢设备？	1
您好，董秘，公司目前订单怎么样？遍布哪些区域？	董秘您好，公司目前的订单情况如何？分布在哪个地区？	1
董秘你好，能不能告知一下公司在建的几个项目建设进度到了百分之多少？	请问董秘，能告诉我公司一些正在建设的项目的建设进展情况吗？	1
尊敬的董秘，您好，电子身份证的数据存储离不开国资云，必须掌握在国家的数据安全库中才能保证数据安全，而这大量的数据离不开的是庞大的数据中心，请问，能否简述一下贵公司在数据中心，或者说数据安全，或者说数字经济领域的优势？	亲爱的董秘，您好，电子身份证的数据存储离不开国资云。必须掌握在国家数据安全数据库中，才能确保数据安全，但如此庞大的数据离不开庞大的数据中心。告辞了。您能否简要说明贵公司在数据中心、数据安全或数字经济方面的好处？	1
董秘您好，请问截至11月19日的股东人数多少，谢谢	董秘你好。到11月19日的股东人数是多少？谢谢。	1
董秘好，截止12月30日，股东户数是多少，减少或增加了	截至12月30日，股东户数减少而增加。	1
夏天来临天气渐渐炎热是否会加大公司遮阳产品在国内需求	夏季炎热的日子会不会增加该公司国内对遮阳产品的需求？	1
董秘您好，请问截止2022年4月29日公司股东人数是多少？谢谢！	董秘，您好，到2022年4月29日，公司股东人数是多少？谢谢。	1
你好，请问和风电相关的上市公司有哪些是贵公司的客户？	您好，风电相关的上市公司中哪些是客户？	1
董秘你好，请问公司有数字相控阵技术和产品储备吗	董秘，您好。公司是否拥有数字相控阵技术和产品储备？	1
您好:请问公司主营产品在市场上的占有率是多少?	您好：公司主要产品的市场占有率是多少？	1
请问董秘产品是军用多还是民用多	请问董秘的产品是军用的吗？还是民间用的？	1
您好，请问，贵公司截止11月30日股东人数是多少？谢谢！	请问到11月30日，你们公司的股东数量是多少？谢谢。	1
董秘您好：请问截止到10.29号的股东人数和机构数各是多少？谢谢！	董秘您好：到10.29为止，股东和机构的数量是多少？谢谢。	1
你好，烦请公布一下最新一期股东人数，谢谢	您好，请公布最新一期股东数量。谢谢。	1
请问贵公司签定的氢能源战略合作协议有没有实质性的项目合作协议及进展?请不要用正在推进中或见公告来推诿,谢谢!	贵公司签署的氢能战略合作协议有没有实质性的项目合作协议或进展？请不要因为看到正在进行或公告而推卸责任。谢谢。	1
董秘，你好，想问一下今年公司的订单如何？工厂是否满负荷运转呢？	董秘你好。我想知道公司今年的订单是多少。工厂运转满了吗？	1
你好，公司之前提到下半年订单有所回落，是同比去年三季度还是比二季度呢？	你好，该公司刚才提到，下半年的订单减少了。是去年第三季度还是去年第二季度？	1
请问公司的产品可以运用于激光雷达吗？	该公司的产品可以用于激光雷达吗？	1
你好，请问贵公司的芯片扩散片车用二极管项目进展如何？计划何时完工投产运营？	请问贵公司芯片扩散芯片汽车二极管项目进展如何？打算什么时候完工投产？	1
请问公司的产品块状海绵是不是用于新能源汽车锂电池阻燃材料？谢谢	请问该公司的产品块海绵是用作新能源汽车锂电池的阻燃材料吗？谢谢你，谢谢	1
截至6.30日公司中标中石油订单金额同比去年同期情况如何？	截至6月30日，该公司中标的中石油订单金额同比？	1
公司董秘你好！针对近期美国政府宣布猴痘成为全国重大公共卫生紧急事件，贵公司在猴痘检测方面会不会输出产品，用以提振公司业绩？国际上给贵公司下的猴痘检测订单是否已经生产？何时交付？请董秘积极回答股东提问，谢谢。	你好，公司秘书！针对美国政府近日宣布猴痘已成为国家重大公共卫生事件，贵公司能否出口猴痘检测产品以提升公司业绩？给贵公司的申痘检验国际订单是否已经编制好了？什么时候能到？请积极回答股东的问题。谢谢。	1
除消费电子外，公司产品在新能源领域有哪些应用？谢谢	除了消费电子产品，该公司的产品在新能源领域还有哪些应用？谢谢你，谢谢	1
请问贵司明年的产能规划是多少？	你们明年的产能计划是什么？	1
您好，贵公司的的热力系统，同样用到热力泵，请问公司有热力泵技术储备吗？热力过剩的时候，公司系统是否可以热力储能。还有公司的系统是否可以用于电力物联网的热电调节以及热力调节，谢谢	请问贵公司的热力系统也用热泵，公司有热泵技术储备吗？当有额外的热量时，公司的系统是否能够储存热能。以及该公司的系统能否用于物联网的热电调节和热调节。谢谢。	1
请问公司订单爆满吗？市场占有率多少？谢谢	公司有很多订单吗？市场占有率是多少？谢谢你，谢谢	1
您好，公司产品用于半导体？	您好，该公司的产品是半导体用的吗？	1
请问公司最新股东人数（截止回复当天）	抱歉，该公司最新的股东数目(截至答覆日期)	1
目前公司的预制体供应商楚江新材也要切入沉积环节，与公司形成直接竞争。请问公司除楚江外，是否还有预制体供应商？楚江与公司同样是某光伏拉晶龙头企业的供应商，待楚江新材沉积产能建成，若通过对预制体环节涨价或断供来与公司竞争，公司打算如何应对？谢谢！	目前，该公司的预成型供应商楚江新材料也要切入沉积环节，与该公司形成直接竞争。楚江以外公司有没有其他预成型供应商？楚江和该公司也是太阳能发电提振龙头企业的供应商。楚江新材料堆积能力完成后，如果公司通过涨价或切断预塑产品供应与公司竞争，公司计划如何应对？谢谢。	1
公司截止到10号股东人数多少	截至10日，该公司的股东数量是多少？	1
您好，请问截止2022年1月20日，贵公司股东人数是多少？谢谢。	您好，截至2022年1月20日，贵公司股东人数是多少？谢谢。	1
请问截止2021.6.20股东人数，谢谢	请告诉我截至2021.6.20的股东人数。谢谢。	1
688180董秘你好，最新礼来61.4万剂的JS016双抗体的订单，对君实四季度的利润有何影响？另外688180股价跌跌不休，严重影响投资者信心，对公司形象以及预期造成影响，董事长3000万回购何时实施？	688180董秘你好，最新的礼来614000剂JS016型双重抗体订单，对君实第四季度利润有何影响？此外，688180股价持续下跌，严重影响投资者信心，影响公司形象和预期。董事长的3000万欧元回购计划何时实施？	1
请问公司的检测中心都可以提供哪些行业的检测服务？测试能力涵盖哪些产品？谢谢	请问公司的检测中心可以提供哪些行业的检测服务？测试能力包括哪些产品？谢谢你，谢谢	1
请问，截至2021年12月1日，公司的股东数是多少？谢谢！！	请问到2021年12月1日，该公司的股东人数是多少？谢谢。	1
公司产品在冷链物流方面有哪些应用？	该公司的产品在冷链物流中有哪些应用？	1
董秘你好！公司的有源相控阵雷达微系统与ADAS系统供应商博世公司的长距离毫米波雷达、中距离毫米波雷达有何区别？公司的有源相控阵雷达微系统技术能否应用到汽车的ADAS高级驾驶辅助系统当中？	你好，董秘！该公司的主动相控阵雷达微系统与ADAS系统供应商博世的远程毫米波雷达和中距离毫米波雷达有什么区别？该公司的主动相控阵微系统技术能否应用于汽车的ADAS先进驾驶辅助系统？	1
请告之截止到2021年11月30日公司的股东人数，祝你身体健康，万事如意.	请告诉我公司在2021年11月30日之前的股东数量。祝你身体健康。希望一切顺利。	1
公司的产品是否可用于芯片，半导体等相关设备中?	该公司的产品能否用于芯片、半导体或其他相关设备？	1
公司股价持续下跌，公司在手现金充裕，强烈建议公司大比例回购股票，维护股东利益！	该公司股价持续下跌，手头现金充裕。强烈建议回购大比例股份，维护股东利益！	1
请问，截至2022年3月18日，公司的股东数是多少？谢谢	告辞了。到2022年3月18日，股东人数是多少？谢谢你，谢谢	1
董秘您好，请问贵公司所研发生产的产品能否做到国产替代？	董秘，您好。你们公司开发生产的产品可以替代国产产品吗？	1
董秘好，作为公司忠实股东，有如下建议：年底分红采取送红股加现金的方式，这样可以降低绝对价格，增加流动性，股票长期走好大小股东以及公司多方共赢，也为公司建立良好口碑，增加竞争优势。纯分现金要扣税除权，股东利益是受损的。不知当否，请公司参考，感谢您的辛勤付出！	公司忠实股东董美浩建议，年底分红采取分红和送现金的方式，可以降低绝对价格，增加流动性，股份长期盈利是大小股东，公司各方双赢。这还为公司树立了良好声誉，增加了竞争优势。净现金必须从税权中扣除，股东利益受损。我不知道是不是。请问公司。谢谢你努力工作。	1
请问公司有没有计划更名？	这个公司有改名字的计划吗？	1
近期锂价持续上扬，公司股价却未能有所体现，公司二期项目何时投产，因该项目对于公司产能有重要影响，建议形成定期报告机制。	最近，锂价格持续上涨，但并未反映该公司的股价。二期项目何时开始投产，项目对公司产能有重要影响，因此建议形成定期报告机制。	1
请问公司在数字货币方面有哪些技术优势？	在数字货币方面，该公司拥有哪些技术优势？	1
请问贵公司截止10月20日，持股股东人数是多少？	截至10月20日，贵公司的股东人数是多少？	1
请问公司除了研发创新能力如何？公司是否计划研发科技含量更高的新产品？具体有哪些？	除了研发，公司的创新能力是什么？该公司是否计划开发科技含量更高的新产品？到底有什么？	1
您好!1.氯化亚砜,目前价格多少?公司实际产能多少? 2.公司芳纶目前产能多少?目前用于新一代锂电池材料,占比多少?有扩产计划?扩产进度目前如何?计划产能多少?什么时候可以投产?	你好！1.现在亚硫酰氯的价格是多少？公司的实际生产能力是多少？2。公司目前的芳纶生产能力是多少？新一代锂电池目前使用的材料比例是多少？有扩大生产的计划吗？目前的生产扩张进展如何？计划的生产能力是多少？什么时候能生产？	1
董秘你好，三氯化磷是用于制备六氟磷酸锂的原材料。数据显示，年初至今，六氟磷酸锂价格已暴涨近6倍。请问公司三氯化磷产品的终端客户有生产六氟磷酸锂的企业吗？	你好，董秘。三氯化磷是生产六氟磷酸锂的原料。数据显示，自年初以来，六氟磷酸锂价格已飙升近6倍。请问该公司三氯化磷产品的终端客户中，有没有生产六氟磷酸锂的企业？	1
董秘您好！“至纯科技在互动平台答投资者关于“十二英寸晶圆再生”提问时表示，合肥新站项目进展顺利，预计会在今年10月份前后落成。”，目前项目进展如何了？何时正式投产？谢谢！	董秘你好。在回答投资者在互动平台上提出的“12英寸晶圆再生”提问时，知春科技表示，合肥新站项目进展顺利，预计今年10月左右完工。“项目目前怎么样？什么时候正式投产？谢谢你！	1
董秘您好，贵公司有辅助生殖的产品或者服务吗？	董秘，您好，贵公司有辅助生殖产品或服务吗？	1
能不能请董秘及时回复为数不多的问题？截止11月20日股东人数是多少？如不能公开，小股民如何获取相关数据，请告知。谢谢	能否请董秘马上回答几个问题？到11月20日的股东人数是多少？如果不能公开，请告诉我小股东如何获取相关数据。谢谢你，谢谢	1
请问截止6月底公司的股东户数是多少？谢谢！	截至6月底，公司股东户数是多少？谢谢。	1
请问到6.20股东人数是多少？	股东人数不超过6.20人有多少？	1
请问公司产品有没有应用在核电站？	该公司的产品是否用于核电厂？	1
公司官网显示，2020年公司通过验收成为第一批“国家电网电工装备智慧物联平台（EIP）”供应商，这对于公司后续发展是不是很有帮助？	公司官网显示，2020年，公司通过验收，成为国家电网电气设备智能物联网平台(EIP)首批供应商，这对公司后续发展有很大帮助。	1
董秘好！9月单一股东巨量解禁，请问是否会延期或者暂缓变现股份呢	董秘你好。大量单一股东在9月解除了这一禁令。是延期还是延期？	1
请问贵公司高管以及实际控制人，有无增持公司股票的计划？	贵公司高管和实际控制人有增持公司股份的计划吗？	1
董秘你好，请问3万吨的新产线产能，给公司会带来多大的营业额增幅？现在的各个生产线的产能是多少？	董秘，您好。3万吨新生产线的产能将为公司带来多少销售额增长？现在各生产线的生产能力是多少？	1
你好，公司出售的有小家电产品么？	请问公司有卖小家电吗？	1
你好,请问公司的产品有涉及钛合金吗?	请问公司的产品涉及钛合金吗？	1
您好，请问公司的电光源玻璃主要应用在哪些领域？  公司或集团是否具备生产LOW-E玻璃的能力或技术？	请问该公司电光源玻璃的主要用途是什么？该公司或集团是否有能力或技术生产Low-E玻璃？	1
请问截止到11月30日的股东总数？	你能告诉我截至11月30日的股东总数吗？	1
请问董秘，公司最近计划购买的浙江独山港经济技术开发区60亩地块，公司计划建设多少平米生产车间呢？计划什么时候建成，什么时候投产呢？今年刚投产的常州厂区，现在产能利用率有百分之多少？ 此致 盼复！	请问董秘，公司最近计划购买浙江独山港经济技术开发区60亩土地，公司计划建设几平方米的生产岗位？什么时候完成，什么时候开始生产？今年刚刚投产的常州工厂产能利用率是多少？我期待着你的回复。	1
你好董秘：中粮福临门是公司子公司吗？	请问董秘：中粮福临门是该公司的子公司吗？	1
公司致力于自动化测试专家，2.电学测试苏州博坤公司预计起量，具体是哪方面客户突破？3.aoi检测设备订单怎么样，和炬子玻璃检测优势是什么，有客户订单吗？元器件检测订单怎么样？4.点胶机等组装设备增长水平 20年三季报推倒重来，期待公司信息交流能引导投资者对公司业务有更深刻认识，不局限于20三季度	本公司致力于自动化测试专家2。苏州博坤电气测试公司有望开始量产，具体而言，客户在哪些方面有所突破？3.aoi检测设备的订购情况如何？对巨子玻璃的测量有哪些好处？有您点的菜吗？零件检查单怎么样？4.点机等组装设备的增长水平在过去20年间发生了逆转。可以预见，公司的信息交流，不仅限于20年第三季度，也会让投资者更深入地了解公司业务。	1
请问四季度公司生产能力是否满足订单需求?谢谢!	你能告诉我公司的产能是否能满足第四季度的订单需求吗？谢谢。	1
《 光热电站电伴热产品供应商久盛电气成功登陆创业板！》新闻报道，请问公司是光热电站电伴热产品供应商？光热电站是不是就是储能电站？公司在光热储能电站领域业务是否在积极拓展？谢谢	“光热电站热能产品供应商久盛电气成功登陆创业板！据报，该公司是光热电站电热产品供应商吗？光热电站是储能电站吗？公司是否积极开展光热蓄热电站领域的业务？谢谢你，谢谢	1
请问贵公司的产品在新能源车领域具体有哪些应用？	您的产品在新能源汽车领域有哪些具体应用？	1
请问贵公司的回购计划实施了吗？有没有买入一丁点了？	贵公司的回购计划实施了吗？买了一点吗？	1
您好董秘，请问截止10月20日，贵公司的股东人数是多少?谢谢您的答复！	董秘您好，到10月20日，贵公司的股东人数是多少？谢谢您的回复！	1
董秘您好，请问下公司主打染料订单有没有新单增加，有没有产线产能的增加？而公司4.6亿闲置资金去做理财，投资者都会理财，上市应该拿钱做更多有利业绩的事，回馈投资者，请正面回复	董秘，您好。公司染料主力订单和生产线产能有增加吗？公司有4.6亿闲置资金做理财，投资者做理财，上市用这笔钱做更有利于业绩的事，回馈投资者，请积极回复	1
请分别介绍一下子公司湖南华联火炬电瓷电器有限公司，和湖南蓝思华联精瓷有限公司的主营业务和产品？蓝思华瓷的5G滤波器芯片，与中瓷电子的产品是否有竞争？	请介绍湖南华联火炬电器有限公司、湖南蓝丝华联精磁有限公司的主营业务和产品。青丝花瓷的5G过滤芯片与中国陶瓷电子产品之间是否有竞争？	1
请问董秘，公司的新能源汽车三电系统产品是否已经量产？据悉广东骏亚也在开始布局汽车电子线路板，请详细介绍下贵司相关的客户开发及认证情况，谢谢！	请问董秘，公司新能源汽车三大电控系统产品已经量产了吗？据悉，广东君亚也开始布局汽车电子电路板，请详细介绍贵公司相关客户的开发和认证情况。谢谢。	1
董㊙️，您好，公司会大手笔回购公司股份吗，以增强投资者信心，公司会公布在手订单吗谢谢	董秘，您好，公司能否以较高的价格回购公司的股票，以提高投资者的信心？公司会发布手头的订单吗？谢谢。	1
请问下公司目前股东人数？ 请问下公司最近没有公司调研？ 请问下冬奥会电力是不是有公司保障？	请问该公司目前的股东人数是多少？告辞了。公司最近没有调查吗？下一届冬奥会用电有公司保障吗？	1
请问贵公司或子公司的技术或，业务，云服务等是否具备东数西算的能力或发展？	您的公司或子公司是否具备技术、业务、云服务等能力或开发能力？	1
您好，想了解如下两个问题，望予以解答：1、公司三季报披露，公司完成了4款MiniLed展示样品及7款MiniLed试产，预计什么时候可以取得厂商的定点订单？是否有新能源车型？2、公司增资东超科技研发【空中成像】技术在车载领域应用进展如何？	你好，我想知道以下两个问题。我想回答这些问题：1.公司三季报显示，公司完成了4个MiniLed显示样品和7个MiniLed的试生产。你打算什么时候收到制造商指定的订单？有新能源车型吗？2、东潮在车辆领域的研发[航空成像]技术进展如何？	1
请问公司股价破发，公司会不会增持？为什么前面的提问不公开？	如果该公司股价被打破，该公司会增收吗？为什么之前的问题没有公开？	1
董秘，您好，请问截止12月10日收盘公司股东人数是多少？谢谢！	董秘，您好，到12月10日，公司股东人数是多少？谢谢。	1
目前新冠疫情防控依旧很严峻，贵公司是否考虑拓展疫情相关产品业务等？	目前，新冠肺炎疫情防控形势依然十分严峻，贵公司是否考虑拓展疫情相关产品业务？	1
公司产品适用于哪些领域？	那家公司的产品适用于什么领域？	1
秘董你好，请问贵司生产状况正常吗？为何股价一直在暴跌，板块大涨，你们股价不涨，板块跌，贵司的股价跌得比板块还要猛！毫无底线啊，坑惨了投资者了。另外请问一下现在的股东人数是多少呢？	请问董秘方，你的生产状况正常吗？为什么股价一直暴跌，板块大幅上涨，而你的股价却没有上涨，板块下跌，你的股价跌幅比板块还要大！没有基线。投资者被愚弄了。顺便问一下，目前的股东人数是多少？	1
你好，请问最新股东人数多少，为了更好的回馈投资者过一个好年，年报是否可以高送转？	请问最新的股东人数是多少？为了在投资者好的一年里更好地回报，年报能否高转？	1
董秘你好：请问双十一你们的销售渠道都有哪些？销量分别如何？	你好，董秘：光棍节你们的销售渠道是什么？销售情况如何？	1
公司的电机和风机等产品在氢能源汽车和加氢站及换电站方面的有哪些应用，公司是否有这方面的产业布局	公司电机、风扇等产品在氢能汽车、加氢站、电站等有哪些应用，公司在这方面有产业布局？	1
贵公司在微信公众号和抖音号等平台上炫耀每日国内外业绩效果！但没有进行流量推广！是订单爆棚无需再接吗？	贵公司以微信公众号和抖音公众号炫耀在国内外的日常表现。但是通信量并不普及！不需要再点了吗？	1
您好，请问董秘:截止7月20号，贵公司的股东人数是多少?谢谢您	请问董秘：截至7月20日，贵公司股东人数是多少？非常感谢你。	1
河南本地法人股东，动用信用账户，几家关联公司大量持有牧原股份。根据中报数据二季度鸿宝可能减持4373万股，请问为什么没有减持公告？同为河南企业，请问大量河南本地营业部席位的大宗交易是否河南鸿宝？河南鸿宝和河南牧原是否存在直接或间接关联关系？	河南当地法人股东使用信用账户，一些关联公司持有大量牧原股份。中国新闻数据显示，二季度红宝可能减少4，373万股。为什么没有关于减税的公告？都是同样的河南企业，大宗交易的大量席位都在河南当地商务部门河南宏宝吗？河南宏宝和河南牧原之间是否有直接或间接的关系？	1
请问大股东质押的股票什么解除质押？	请问大股东质押股票的质押解除是什么？	1
请问贵公司在民用领域除了无人驾驶和5G通信领域之外，是否有其他拓展意向？贵公司产品和技术在民用无人机领域，AR所采用的全场景建模领域，VR全浸入元宇宙联网游戏的定位领域是否都有一席之地？	除了自动驾驶和5G通讯，贵公司有没有在私营领域扩张的其他意图？贵公司的产品和技术在民用无人机领域、AR使用的全场景建模领域、完全沉浸在Metacosmos网络游戏中的VR定位领域有席位吗？	1
截止你回复之日.股东人数是多少？	从回信之日起。股东人数是多少？	1
请问截止8月20日股东人数？机构股东数？	你能告诉我8月20日之前的股东人数吗？机构股东的数量？	1
请问公司的产品业务近几年呈爆发式增长趋势，公司是如何保障产品供应？宁德时代是公司的重要战略伙伴关系，宁德即将在国外建厂供货特斯拉和福特电池，公司是否有考虑国外市场的相关合作布局？请问公司目前研发的项目主要有哪些方面？请问公司目前订单是否饱满，处于满负荷生产？谢谢	请问近年来公司产品业务呈现爆发式增长趋势，公司如何保障产品供应呢？宁德时代曾是公司的重要战略合作伙伴。宁德即将在海外设立工厂，供应特斯拉和福特电池。公司是否考虑过在海外市场的合作布局？该公司目前的研发项目主要有哪些方面？请问该公司目前的订单是满员和满载吗？谢谢你，谢谢	1
深能爱众经营范围包含空气能热泵、抽水蓄能、储能、充电桩。能否具体介绍一下贵公司的持股占比和该公司的经营范围？	深能爱中的业务范围包括空气能源热泵、抽水蓄能、储能和充电桩。你能介绍一下持股比例和公司的业务范围吗？	1
请问公司目前现有HiB产能是怎样？有多少是中高牌号的？	该公司目前的Hib产能是多少？中级和高级有多大？	1
董秘，您好！请问截止10月29日收盘，公司股东户数是多少，谢谢！	董秘你好。截至10月29日底，公司股东数量是多少？谢谢。	1
解禁后实控人一再减持股份，请帮普通投资者解读一下贵公司股份是否还能继续长期持有？谢谢	解禁后，实际控制人多次减持股份。帮助普通投资者破解你的股票是否能长期持有。谢谢你，谢谢	1
国家铁路局发文“十四五”时期加快推进“八纵八横”高速铁路主通道建设，贵公司有哪些业务能够支持建设的？谢谢	国家铁路局发文称，要加快推进“十四五”期间高铁建设。贵公司可以支持哪些业务建设？谢谢你，谢谢	1
您好，董秘，请问截止2021.1105日股东人数是多少？	董秘，您好，到2021.1105，股东人数是多少？	1
请问公司产品可用于锂电池材料或者电解液吗？谢谢	该公司的产品可以用于锂电池材料或电解液吗？谢谢你，谢谢	1
董秘你好,请问贵公司产品有无提供给神舟飞船?谢谢	董秘，您好，有神舟飞船的产品吗？谢谢你，谢谢	1
2021年度,公司预计检验检测信息收入将增长25.03%~33.18%,增长速度仍然较快。请问检验检测领域业务占比大概有多少？公司在检验检测领域业务占比有没有50%？谢谢	2021年，该公司预计检验检验信息收入增长25.03%至33.18%，增速依然较快。检验检验领域的业务占多大比例？公司在检验检验领域的业务占有率是50%吗？谢谢你，谢谢	1
尊敬的董秘，请问公司截止至十月底或今日的股东户数是多少？真是麻烦您了	尊敬的董秘，10月底或今天，公司股东户数是多少？很抱歉给您添麻烦了。	1
徐总您好，公司目前有储备秸秆保温材料技术吗？谢谢	请问徐总经理，公司目前有储存秸秆保温材料的技术吗？谢谢你，谢谢	1
能不能说明一下现在大路煤制油项目进展，以及伊犁煤制油项目进展。面临的困难，以及银行贷款的具体情况。	能否说明戴尔煤油项目和伊利煤制油项目的进展情况？面临的困难，以及银行贷款的具体情况。	1
目前新冠病毒德尔塔和奥密克戎变体对全球疫情造成了“双重威胁”，请问公司的产品能否参与其中，能起到什么作用？ 谢谢	目前，新型冠状病毒Delta和O‘Micron变种对全球疫情构成“双重威胁”。公司的产品能否参与，又能起到什么作用？谢谢你，谢谢	1
请问：1.公司的污水处理技术和产品能否适用核污染海水的处理？2.公司除现有污水处理技术外，还有其他创新技术储备吗？3.清华大学深圳研究院开发的环保领域其他先进技术，比如大气、土壤等方面的先进污染治理技术是否会进入公司？	打扰一下：1.该公司的污水处理技术和产品是否适合处理核污染海水？两个人。除了现有的污水处理技术外，该公司还有其他创新的技术储备吗？3、清华大学深圳研究院研发的其他环保领域的先进技术，如空气或土壤，会进入公司吗？	1
请问公司是否有国际业务？	这家公司有国际业务吗？	1
公司官网介绍改性塑料现已逐步代替传统无机材料如金属、玻璃、陶瓷等用于生产各类医疗器械和医护用品，目前聚赛龙为口罩、防护服等提供材料解决方案。那请问，假如现有客户公司向公司咨询新冠抗原检测盒业务，公司有能力与技术向客户提供材料解决方案吗？	该公司官网显示，在各种医疗器械和医疗用品的生产中，改性塑料逐渐取代了金属、玻璃和陶瓷等传统无机材料。目前，宝赛龙为口罩和防护服提供了材料解决方案。请问如果现有客户公司咨询新冠肺炎抗原检测套件业务，公司是否有能力和技术为客户提供物质解决方案？	1
请问扁线产能情况	我可以问一下扁平生产线的生产能力吗？	1
未来国内其他公司对二倍体疫苗逐步研发成功，贵公司产品在国内市场饱和的情况下在国际市场竞争力如何？	未来，国内其他公司也将陆续成功研制出二倍体疫苗。如果国内市场饱和，你们的产品在国际市场上的竞争力如何？	1
尊敬的上市公司你好，2022年的春节即将到来，通常这是食品消费行业的旺季，请问上市公司在春节来临之际，有什么计划促进销量吗？今年有什么销售上的发展规划吗？谢谢。	亲爱的上市公司，您好，2022年春节即将到来，通常是食品消费行业的旺季。春节临近，上市公司是否有促销的计划？你们今年有什么销售发展计划吗？谢谢。	1
请问1月10日公司股东人数一共多少户？谢谢！	截至1月10日，该公司股东总数是多少？谢谢。	1
你好，请问公司上市募资比原计划多出的15亿公司有和计划和安排，是收购公司增加新业务多元发展还是继续做大做强？	请问公司上市募集资金超过原计划15亿的公司是否有计划和安排？收购公司是扩大多元化发展的新业务，还是要继续做大做强？	1
请问贵公司截止12月27日股东人数是多少？？？	截至12月27日，贵公司的股东人数是多少？	1
董秘好，看公司网站及招股书提到，公司产品有用在光伏方面，如光伏电站，是否属实？	董美娟在阅读公司网站和招股书后表示，该公司的产品在太阳能电站这样的太阳能电站领域是有用的，这是真的吗？	1
请董秘概述一下公司在元宇宙方面的优势及所做的工作，谢谢。	请概述该公司在梅德巴斯方面的优势及其努力。谢谢。	1
董秘您好子公司江门长城紫晶计算机系统有限公司是否有物联网技术研发；人工智能基础资源与技术平台；智能控制系统集成；云计算设备制造等相关的技术	请问董秘，江门长城紫晶计算机系统有限公司是否拥有物联网技术研发；人工智能基础资源与技术平台；智能控制系统整合；云计算设备制造等相关技术？	1
尊敬的董秘您好，贵公司扩产的产能快能量产了，那么贵公司业务量有信心能同时提升上去吗？公司内部制定的销售计划和目标是什么？请说明下贵公司未来的销售计划及销售目标。	尊敬的董秘，贵公司扩大的产能即将产生能量，是否有信心同时增加业务量？公司内部制定的销售计划和目标是什么？请说明您未来的销售计划和销售目标。	1
业界里面基本认可贵公司RIGOU品牌产品在行业内国内一哥的地位。国内这么多高等院校实验室，高端制造业，航空航天军事，半导体产业，电子制造业都需要各类示波器等仪器，为何贵公司仍然市场占有率不高？无法替代国际一线品牌产品？是因为自产的ADC芯片不够高端吗？	贵公司的日沟产品几乎是业界公认的行业第一。国内高校、高端制造、航天军工、半导体工业、电子制造等许多实验室都需要各种示波器等仪器，为什么贵公司的市占率仍然很低？能否取代国际一线品牌的产品？因为国产ADC芯片不是高端的吗？	1
请问今年双11的销售额是多少？相比往年增加多少个百分比	今年双11的销量是多少？比几年前增加了多少%？	1
截止2021年11月10日公司股东人数是多少？谢谢	到2021年11月10日，股东人数是多少？谢谢你，谢谢	1
公司硫酸产品从去年年中到现在价格涨了7倍，与硫酸产品大量应用于新能源产业是否有关？谢谢。另外公司硫酸产品生产订单充沛吗？	自去年中以来，该公司硫酸产品的价格上涨了7倍。这是否与新能源产业中大量使用硫酸产品有关？谢谢。此外，该公司是否有足够的硫酸产品生产订单？	1
公司产品是否可以用于新冠药方面？为什么不敢大胆承认？	该公司的产品可以用于新冠药吗？为什么不能承认呢？	1
美国的医院是否是公司的客户？用于病人的新冠病毒消杀防护？	美国的医院是该公司的客户吗？为驱除患者新型冠状病毒的保护？	1
请问公司产品有对外贸易吗？	请问公司的产品有外贸业务吗？	1
为何不公布最新股东人数？	为什么不公布最新的股东数量？	1
首先感谢你们不辞辛劳的回复我们提出的问题。請問把带有时间和姓名的股票交易软件持仓截图和身份证一并扫描发送至公司邮箱，可以获知 非定期报告相关时点的股东人数吗？盼你们具体，明确答复。顺祝你们，身体健康，万事如意, 【比如截至到2022年7月31日贵公司的股东人数是多少？】	首先，谢谢你不厌倦地回答我们的问题。能否通过将有时间、姓名和身份证的股票交易软件截图扫描到公司邮箱，了解不定期报告相关时间的股东人数？我们期待着你具体而明确的答案。祝你身体健康。希望一切顺利。[例如，截至2022年7月31日，贵公司的股东数量是多少？“”	1
您好，请问，贵公司截止7月20日股东人数是多少？谢谢！	请问到7月20日，你们公司的股东数量是多少？谢谢。	1
请问贵公司三季度产能利用率是否在100以上？	请问贵公司第三季度产能利用率是否超过100%？	1
您好，贵公司苏州生产基地已经完工了吗？没有的话2020年能否完工？	请问你的苏州生产基地建成了吗？如果不是的话，到2020年能完成吗？	1
尊敬的董秘，您好！南海减持时间早已过半，为何没有披露减持进展公告，请督促做好披露工作。谢谢！	尊敬的董秘，你好？南海中国减持时间已过半，为何不披露公告进展情况，请督促披露工作。谢谢。	1
请问当前股东数何时公布	目前的股东数量何时公布？	1
您好，尊敬的董秘。随着部分地区干旱以及限电，对于金龙鱼基地生产是否有影响？	尊敬的董秘，你好。随着部分地区的干旱和停电，会不会影响金良基地的生产？	1
贵公司截止12月3日股东人数是多少	截至12月3日，贵公司的股东人数是多少？	1
公司目前产能利用率如何，是否饱满状态？	该公司目前的产能利用率是多少？满了吗？	1
你好，股东人数不是应披露的信息吗？问你了却让我们投资者拿相关材料去查，那还需要问你吗？这样公司算不算有应披露而未披露？	您好，股东人数不是应该公开的信息吗？但是，如果我们的投资者拿着相关资料去查一下，我还需要问你吗？这是否意味着公司必须被披露，而不是被披露？	1
请问公司有考虑回购股份进行市值管理吗？	该公司有没有考虑过回购股票进行市值管理？	1
贵公司的产品是否用于氢燃料车上？	你们的产品是用于氢燃料汽车的吗？	1
董秘你好，公司股东人数顶峰是3.89万，半年时间，只剩下1.1万，投资者明显已经对贵司失去了信心，贵司是否对自己在行业的发展有信心？	你好，董秘，公司股东人数峰值为38900人，半年后只剩下11000人。投资者显然对你的公司失去了信心。你对自己在这个行业的发展有信心吗？	1
董秘好，请问公司产品是否有应用于c919大飞机？	董美，该公司的产品用在C919飞机上吗？	1
母公司亚光科技集团有限公司的主要供应商有哪些，前五大供应商占比分别多少？	母公司亚光科技集团有限公司的主要供应商有哪些？排名前五位的供应商所占比例是多少？	1
董秘你好,这个月的解除质押进度几号公布?	你好，董梅。本月质押释放进展何时公布？	1
请问贵公司截止11月22日，股东人数是多少？？？	截至11月22日，贵公司的股东人数是多少？	1
董秘，你好，请问最近半年的折价大宗是怎么回事？是否是大股东在减持？	请问董秘，你能告诉我最近六个月的折扣发生了什么吗？是大股东减产的吗？	1
公司产品有用于汽车上吗？用于哪几个品牌？	那家公司的产品用于汽车吗？用的是什么牌子的？	1
海康威视是公司的客户吗？海康威视旗下也有机器视觉相关业务，两者是否有竞争关系？	海康威视是该公司的客户吗？海康威视也有机器视觉相关业务，两者之间是否存在竞争关系？	1
公司在之前介绍2021年底募投项目主体将完工，目前已到2022年，请介绍下公司募投项目进展情况？	公司介绍招聘项目主体到2021年底完工，目前已是2022年，请介绍公司招聘项目的进展情况。	1
公司是否具备研发仿制药的能力？	那家公司有能力开发仿制药吗？	1
董秘，你好。了解一下当前IC载板项目的进度，以及该项目未来规划	董秘你好。了解目前IC板项目的进展情况和项目未来的规划。	1
贵司今年的新能源汽车和氢能源设备产能和销量如何？	贵公司今年新能源汽车和氢能设备的产能和销量是多少？	1
你好，请问目前公司Mini LED产能有多大？主要客户有哪些？今年销售情况如何，明年又是怎样的展望？谢谢！	您好，该公司目前迷你LED的产能是多少？主要客户是什么？今年销售情况如何，明年前景如何？谢谢。	1
您好董秘，请问截止10月31日，贵公司股东人数是多少？谢谢	董秘先生，您好，到10月31日，贵公司的股东人数是多少？谢谢你，谢谢	1
董秘您好。 听说联电1月份又开始涨价了。而且据新闻说，联电明年3月份还想继续涨。 联电如此行为，会不会压缩芯片公司的利润空间？贵司是否有考虑更换晶圆厂？ 是否应该分散产能，尽量少找这种不正规的，涨价无度的晶圆厂。	董秘你好。联电1月份又开始涨价了。另一方面，消息面显示，联电希望在明年3月继续上升。如果联电这样做，会不会压缩芯片公司的利润率？贵公司考虑过更换工厂吗？我们是不是应该分散产能，尽量少找到这种非正规、肆无忌惮的晶圆厂？	1
请问贵公司所采购的膜产品是国外进口还是国产品牌？比如三达膜或者碧水源的产品质量已经很好了。	请问贵公司购买的胶片产品是从国外进口的吗？还是国产品牌？例如，散打薄膜或碧树水源的产品质量已经很好。	1
尊敬的董秘，您好！欧洲电力供应紧张，可能会用上蜡烛，请问贵公司最近出口到欧洲的蜡烛情况如何？	尊敬的董秘，你好？欧洲电力供应不足，可能会用蜡烛。最近出口到欧洲的蜡烛情况如何？	1
截止到10月29日公司股东人数?	截至10月29日，该公司的股东数量是多少？	1
请问公司产品可以用于新能源汽车哪方面？客户都有哪些知名公司？	请问该公司的产品可以用于新能源汽车吗？顾客有什么有名的公司？	1
您好，近期A股市场包装印刷行业异常火爆，也许反映出该行业整体效益不错。公司具体为哪些印刷行业A股上市公司供应商品和服务？	您好，近期A股市场包装印刷行业异常火爆，或反映行业整体效益良好。印刷行业有哪些A股上市公司专门提供商品和服务？	1
董秘，你好！贵公司有没有产品应用于北京冬奥会？	董秘你好。贵公司有北京冬奥会用的产品吗？	1
请问贵公司截止昨日收盘后 最新股东人数是多少？	截至昨天收盘价，贵公司的最新股东人数是多少？	1
请问 截止10月20日收盘，贵公司股东人数是多少？谢谢	截至10月20日止的收盘时，贵公司的股东人数是多少？谢谢你，谢谢	1
新闻报道，最近预制菜的市场需求火爆，甚至出现货车排队等拉货的状态，请您说一下公司最近产品的情况，以及是否有提价的意向。谢谢	据新闻报道，近期，市场对熟菜的需求非常旺盛，也出现了卡车排队拉货的情况。请告诉我该公司最近的产品，以及是否有提价的意图。谢谢你，谢谢	1
请问贵司跟立昂技术在业务上是否为竞争对手？两公司主营业务是否存在同质化或者说是关联交易方？谢谢	请问贵公司和Lion科技在业务上是竞争对手吗？两家公司的主营业务是否存在同质化或关联方？谢谢你，谢谢	1
你好，请问公司现在是否订单不足呢？听说公司十一放假半个月是否属实呢？	请问公司现在订单不够吗？公司真的有半个月的国庆假期吗？	1
董秘您好，请问锂电池回收建设进度到哪一步了，预计何时投产，除了提取碳酸锂材料还要提取其他材料吗，提取的碳酸锂是否能够直接适用于锂电池，回收废旧锂电池提取产出比是多少，前景如何，谢谢回答！	请问董秘，锂电池回收建设进展如何？你打算什么时候开始生产？除了提取碳酸锂材料，还需要提取其他材料吗？提取的碳酸锂可以直接应用于锂电池吗？废旧锂电池回收的提取率是多少？前景如何？谢谢你回答我。	1
你好：Facebook要进军元宇宙行业，VR产品会带来几何级的增长。请问Facebook是公司的客户吗？	你好：Facebook正在进军元巴斯产业，VR产品将带来几何体增长。Facebook是该公司的客户吗？	1
您好，请问，贵公司截止10月31日股东人数是多少？谢谢！	请问到10月31日，你们公司的股东人数是多少？谢谢。	1
最新公告拟接受股权抵押，请问是否严谨，应为股权质押，请核实。	最新公告预计将接受股票质押。请问是否严格，应该作为股票质押。请确认一下。	1
请问公司领导，因为商业保密问题，简短的询问下公司的新能源汽车三电系统控制板从设计开发到最终的产品品质稳定成熟量产这个周期大概有多长，请告知，谢谢。	我想问一下公司领导，由于商业秘密，我想简单地问一下，从公司新能源汽车三电系统控制板的设计开发到最终产品质量稳定成熟的量产周期有多长，请告诉我。谢谢。	1
请问，截至2021年11月30日，公司的股东数是多少？谢谢	请问到2021年11月30日，该公司的股东数量是多少？谢谢你，谢谢	1
请问公司是否有新冠疫情防控产品？	该公司是否拥有新冠肺炎疫情防控产品？	1
公司为什么定位于“小批量”类产品，为什么不做有量的产品？是否公司竞争力不足？	为什么要将公司定位为“小批量”产品？为什么不大量生产产品呢？这家公司的竞争力还不够吗？	1
尊敬的董秘：     公司21年业绩暴增120%，且IPO后每股净资产高达67.66元.同时每股公积金10.35元.未分配利润23.98元，均符合高增长，业务规模扩大，三高，没有减持的交易所的高送转条件，建议公司采取高送转，扩大股本规模，增加流动性！谢谢	尊敬的董秘：公司21年业绩暴涨120%，IPO后每股净值达到67.66元。此外，公积金为每股10.35元。未分配利润23.98元，均符合高增长、业务规模扩大、三高、不减薪高额转让的条件，公司建议高额转让、扩大股票规模、增加流动资金！谢谢你，谢谢	1
公司现阶段是特斯拉的客户吗？	在这个阶段，该公司是特斯拉的客户吗？	1
公司有没有向血管介入相关医疗设备延伸的计划与技术储备？谢谢	该公司是否有延长与血管干预相关的医疗器械的计划和技术储备？谢谢你，谢谢	1
自贵司上市以来，股价接连下跌，请问贵司是否有考虑过相应的主动市值管理措施，比如有无考虑通过二级市场的增持来维持中小股东的利益？另，距离贵司的定增失效时间表仅剩2个月左右，相关的定增工作是否仍在正常进行？有无相应的接洽对象？	自贵公司上市以来，股票价格不断下跌。贵公司在二级市场增资维护中小股东利益等，是否考虑过相应的积极市值管理措施？此外，距离你的定增失败时间表只有大约两个月，相关的定增是否正常进行？有相应的联系方式吗？	1
公司说要进军车载液晶显示器的领域吗，合作商京东方拟募投车载显示电子，是否会对公司冲击，公司与京东方的战略合作是什么模式？	该公司是否表示将进军车载LCD领域？合作伙伴京东方是否计划为车载显示电子产品筹集资金？这会影响公司吗？公司与京东方的战略合作模式是什么？	1
您好，目前公司在手订单是否在持续增长？	您好，目前公司手头订单还在增加吗？	1
随着单身经济兴起，小家电市场火爆，贵公司是否有在相关产品设计研发方面布局？	随着单一经济的崛起和小家电市场的蓬勃发展，贵公司在相关产品的设计开发上是否有布局？	1
尊敬的董秘，请问公司产品有没有用到换电站业务的？因为换电站会用到大量电机，包括起落，通风等环节	尊敬的董秘，公司的产品是否用于电站改装业务？因为变电站使用大量的马达，如起降、通风等。	1
您好，请问截止到2021年12月10日收盘的股东人数是多少呢。谢谢啦！	您好，截至2021年12月10日，截止日期的股东人数是多少？谢谢。	1
请问公司产品是否可以应用于无人驾驶？谢谢	该公司的产品可以应用于自动驾驶吗？谢谢你，谢谢	1
公司有哪些高科技产品应用到设计规划建设中？	公司的设计、规划、建设中使用了哪些高科技产品？	1
董秘您好，在雷达芯片领域，贵公司和万邦微电子相比有什么优劣势？	您好，与董秘、万邦微电子相比，贵公司在雷达芯片领域有哪些优势和劣势？	1
董秘你好，贵司拥有黑龙江省中小学教材独家发行资质，是黑龙江省内唯一上市文化企业。请问贵司在在线教育方面有哪些技术储备？	您好，董秘，贵公司拥有黑龙江省中小学教材独家销售资质，是黑龙江省唯一一家上市文化企业。你在在线教育方面有哪些技术储备？	1
请问代工占用多少产能？	OEM的生产能力是多少？	1
董秘，您好！请问贵司产品是否有USB-C接口和配套生产产线、产能？如果有能否提供相关数据？	董秘你好。您的产品是否有USB-C接口和配套的生产线和生产能力？如果有的话，可以提供相关数据吗？	1
媒体近日报道，我公司旗下园区--德必虹桥绿谷WE2020年获得上海虹桥商务区管理委员会颁发的虹桥商务区全球数字贸易港承载平台奖项。  请问除了上述报道内容，公司在数字贸易领域还有什么布局和发展战略？	近日，有媒体报道，该司园区--德壁虹桥绿谷WE2020荣获上海虹桥商务区管委会颁发的虹桥商务区全球数字贸易港平台奖。除了上述报道，该公司在数字贸易领域的布局和发展战略是什么？	1
公司的IT柜是否可以应用于数据中心，公司是否能参与到东数西算当中，或者没有有已经参与到其中，公司产品是否具备东数西算的参与条件？谢谢。	公司IT柜是否可在数据中心使用，公司是否能够参与物计算，是否已经参与，公司产品是否具备参与物计算的条件？谢谢。	1
最新公告里说充电桩项目对公司2021年和2022年第一季度影响甚微，强调这个时间节点的话是不是可以这样理解，那充电桩项目已经爬完坡了，会对第二季度乃至2022年整个业绩起到飞跃式提升的作用？请不要回避问题，董秘办要有所作为。	最新公告显示，充电桩项目对公司2021年和2022年一季度影响不大。充电桩项目已经爬完坡，你能理解对二季度和2022年整体业绩产生跳跃式的影响吗？请不要回避这个问题。董建华的秘密事务所应该在做些什么。	1
董秘您好！请问贵公司的药用包装玻璃、耐热玻璃和电光源玻璃等系列产品能否用于新冠疫苗、新冠特效药等使用？谢谢！	董秘你好。你们系列药品包装玻璃、耐热玻璃、电光源玻璃能否用于新冠肺炎疫苗、新冠肺炎特药等？谢谢。	1
请问公司光电产品和中波红外产品今年是否有增长？公司是否掌握短波红外技术？谢谢！	请问今年该公司的光电产品和中波红外产品有没有增加？这家公司掌握短波红外技术吗？谢谢。	1
公司大股东国美控股集团质押的4310万股下个月即将到期，能否按期还款解除质押？是否会造成抛售？	该公司大股东国美控股集团质押的4，310万股股票将于下月到期。能按时偿还贷款，解除质押吗？这会导致抛售吗？	1
您好，请问截止2021年10月31日，贵公司股东人数是多少？谢谢。	您好，截至2021年10月31日，贵公司股东人数是多少？谢谢。	1
你好，公司的上市招股书上提到，公司有临氢工况关键阀门国产化的项目研发，这个项目是怎么样的？公司产品在含有以氢气为介质的项目上是否有应用到？	您好，该公司上市招股说明书中提到，该公司有氢条件下关键阀门国产化的研发项目。这个项目是什么样的？该公司的产品是用于通过氢的项目吗？	1
董秘，您好！首先恭喜贵司成功上市！公司业务在三元材料上已经涵盖了正极所需的镍、钴、锰，请问未来还会开拓锂材料相关业务吗？	董秘你好。首先，恭喜你成功上市。该公司的业务涵盖三元材料中阴极所需的镍、钴和锰。未来与锂材料相关的业务会发展吗？	1
博云新材说成为C919的独家刹车片供应商，属实否？	博云新材成为C919刹车片独家供应商是真的吗？	1
董秘您好，请问第二届"全球6G技术大会”将于2022年3月22日-3月24日在南京重启举办，公司主营移动终端电子产品及电子工业领域的治具及设备的研发与生产，公司具是否具备相关技术储备和开展6G业务？谢谢	董秘，您好。第二届“世界6G技术大会”将于2022年3月22日至3月24日在南京举行。公司主要从事移动终端电子产品和电子工业领域的夹具和设备的研发和生产。公司是否有相关技术储备，开展6G业务？谢谢。	1
董秘您好，请问截止8月20号，贵公司股东人数是多少?谢谢	董秘你好。截至8月20日，贵公司的股东人数是多少？谢谢你，谢谢	1
你好美女董秘,请问现阶段安徽金日盛公司经营状况如何,产能释放怎样,有没有新的产能投放	你好，我是美女董秘。安徽今日盛会公司现阶段经营情况如何？产能释放情况如何？有新的生产能力吗？	1
公司11月30日股东人数是多少	11月30日，该公司的股东数量是多少？	1
你好董秘！请问公司产品是否应用与航空航天领域？主要客户有哪些？	董秘你好。该公司的产品是否在太空领域使用？主要客户是什么？	1
请问公司辽源鸿图作为国内高端湿法锂电池隔膜供应商，是否有PVDF油性涂覆产线？	请问辽源宏图公司作为国内高端湿式锂电池隔板供应商，有PVDF油膜生产线吗？	1
您好，公司在答复投资者有关全年业绩预测数据提问时，多次强调2021年数据请关注公司2021年年报。请问上述表达是否可以理解为公司2021年全年经营业绩和财务状况不存在按规定需要预告的情形，投资者只需直接关注公司2021年年报?谢谢！	您好，在回答投资者对年度业绩预测数据的提问时，公司多次强调2021年数据要关注公司2021年年报。请问上述表述能否理解为公司2021年年度经营业绩和财务状况无需提前公布？投资者直接关注公司2021年年报就可以了吗？谢谢。	1
董秘您好，请问截止4月8日收盘的股东人数，谢谢，祝工作顺利！	董秘你好。我想问一下4月8日收盘价的股东人数。谢谢。我希望工作的一切都顺利。	1
贵公司的产品远销国外，质量良好，外国疫情比较严重，对消毒湿巾需求是否大幅提升？	贵公司产品远销海外，质量好，国外疫情比较严重，消毒湿纸巾的需求大增了吗？	1
氢能源已提升为国家战略，公司产品在氢能源领域有哪些应用？谢谢	氢能被提升为国家战略。该公司的产品在氢能领域有哪些应用？谢谢你，谢谢	1
董秘您好，请问截止12月20日，公司股东人数是多少？	董秘，您好，到12月20日，公司股东人数是多少？	1
公司是做智慧医疗方面的龙头，请问有没有开发一些APP之类 让体验一下，谢谢	该公司是智能医疗领域的领军人物。你开发过体验型应用程序吗？谢谢。	1
7月24日的回复中，公司告知“向大型的央企、国企、前50强等客户倾斜，并且有明显成效，同时前五大客户占比继续向下改善”，但是公司连续两年没有得到万科A级供应商，公司前五大客户占比向下，是公司主动调整还是满意度下降后客户专门降低呀？公司今年在前五大客户中的口碑如何？	该公司在7月24日的回复中通报，“向大型央企、国企、50强等客户倾斜，取得明显成效，而前五大客户占比持续提升”，但公司连续两年未拿到万科A级供应商，而且公司前五大客户占比下降，是公司主动调整了，还是客户满意度下降后具体下降了？在今年排名前五的客户中，该公司的声誉如何？	1
您好，请问截止7月20日，公司的股东户数是多少？谢谢，麻烦您了！	请问到7月20日，公司股东户数是多少？谢谢给您添麻烦了。	1
请问公司为抗新冠疫情，重点研发的项目“一种高浓度次氯酸防疫消毒产品成套技术及装置集成研发项目”，什么时候可以量产呢？	为防范新冠肺炎流行，公司重点研发项目“高浓度次氯酸盐防疫消毒产品配套技术与设备”何时量产？	1
小米公司是公司的客户吗？小米现在要造车了，而公司目前的新能源车配件也在拓展期，公司有可能利用之前和小米公司良好的合作关系，将公司新能源汽车配件打入小米汽车？对公司来说，之前老客户介入汽车行业，对公司相关产品有可能带来拉动吗？	小米是该公司的客户吗？小米现在造车，公司目前的新能源汽车零部件也处于扩张期，公司是否有可能利用与小米的良好关系，将公司的新能源汽车零部件放入小米汽车？对公司来说，在老客户涉足汽车行业之前，有没有可能给公司的相关产品带来拉动？	1
您好，请问公司是否有支持汽车黑匣子和行车记录仪的技术和产品？理论上来讲汽车中控平台是应该有能力发展兼容汽车黑匣子的技术，请问公司目前有什么发展计划？	请问公司有支持车载黑匣子和行车记录仪的技术和产品吗？从理论上讲，汽车中控平台应该能够开发兼容的汽车黑匣子技术。那家公司目前的发展计划是什么？	1
你好，请问贵公司是否有从事“镁”这一方面的生产。	请问贵公司从事镁生产吗？	1
请问董秘：截止12月15日股东人数多少？今年效益相比有增长吗？	董秘：截至12月15日的股东人数是多少？今年的效率提高了吗？	1
公司产品应用场景有哪些？难道主要只是用于科研院所研发使用？那如果这样的话，公司产品的市场需求也太小太单一了！	该公司的产品有哪些应用场景？它主要用于科研院所的研发吗？如果是这样的话，市场对该公司产品的需求太小，太单一了！	1
尊敬董秘您好，请及时回答一下关于升级扩产项目，部分设备已在投入增加产能，请问今年四季度比去年四季度的产能预计能增加百分之多少？明年完全达产后的产能，又比往年没有升级扩产时侯的产能增加百分之多少？	尊敬的董秘，你好。请及时回答扩展项目的升级。一些设备投入了生产能力的提高。预计今年第四季度产能将比去年第四季度增加多少？明年全面达产后，与往年未升级扩容时相比，产能将增加多少？	1
贵公司在光伏、芯片及半导体领域是否已经立项？目前进展如何？相关专利有哪些？	贵公司是否在太阳能发电、芯片和半导体领域设立了项目？到目前为止进展如何？有什么相关专利？	1
据了解，贵公司与深圳市标准技术研究院以及小米、OPPO、vivo、华为、联想等共同制定了智能穿戴设备等产品的检测标准。请问智能穿戴产品是否包括无线耳机、VR眼镜等？	据了解，贵公司与深圳市标准技术研究院和小米、OPPO、vivo、华为、联想等产品共同制定了智能穿戴设备测试标准。智能可穿戴产品是否包括无线耳机、VR眼镜等？	1
请问公司产品是否应用在消费电子产品领域?	该公司的产品用于消费电子领域吗？	1
请问公司近期新冠防控相关的订单是否有所增加	你能告诉我最近关于预防控制新冠肺炎的订单增加了吗？	1
请问华为、小米、oppo是否使用贵公司产品？	华为、小米和OPPO用你们的产品吗？	1
请问公司2022年有向市场推出什么新产品吗？	该公司将在2022年向市场推出哪些新产品？	1
公司的NFT技术有哪些应用场景，可以应用于元宇宙吗？	该公司的NFT技术在梅德巴斯的应用场景中有哪些可以应用？	1
请问：公司4季度新接订单情况是否符合预期？	请问公司在第四季度收到的新订单是否符合预期？	1
请问贵公司电子级化工产品有哪些？占产品总收入比例多少？	贵公司的电子级化学制品有哪些？产品占总收入的比例是多少？	1
请问公司车用尿素产能多少？目前多少价格？	该公司的汽车尿素生产能力是多少？现在的价格是多少？	1
请问公司募投项目进展如何，何时投产。	请问公司的筹款项目是怎样的？什么时候开工？	1
根据公司文件显示，2020 年度，公司自制供应占比 48.14%、OEM 供应占比 35.48%、集约化采购占比 16.38%。请问董秘，公司侧重哪一方面，未来哪一方面的占比会提升？集约化采购的模式如何保证供应商的成品质量，成为供应商是否有较为严格的审核？	公司文件显示，2020年，公司自制交付48.14%，门牌交付35.48%，集约化采购16.38%。董秘，公司专注于哪方面，将来哪方面的份额会增加呢？集约化采购模式如何保证供应商成品质量？对供应商有更严格的审核吗？	1
尊敬的董秘，公司8英寸硅片生产线早在年初已经打通，如果公司的产品质量可靠，送样、验证、下单不至于这么长的时间还没有任何批量订单产生，请问：公司所说的“产品已进入客户认证流程，进展顺利”体现在哪里？	亲爱的董秘，该公司8英寸硅片生产线年初开工。如果公司产品质量可靠，在样品交付、验证、订单发送上花费这么长时间就不会产生任何大量订单。请问该公司所谓的“产品已列入客户认证程序，进展顺利”在哪里？	1
网上说贵公司只有翼龙1和翼龙2两个型号的无人机，而且贵公司没有研发新型号的能力，全部靠大股东转让，是否属实？请明白回复。另外，公司半年报不理想，是否成长性不足？三季报和年报，公司有能力预盈预增吗？在手订单有多少？	网上称，你的公司只有翼龙一号和翼龙二号两种无人机。而且你的公司没有能力开发新模式，都是大股东转让的东西。这是真的吗？请理解并回复。此外，公司半年报并不理想，但缺乏成长性吗？第三季报、年报、公司是否有能力上调盈利预期？你手头有多少订单？	1
公司是中国唯一一家获得CRRT型体外循环血路产品注册的公司。请问公司参与制订的国家标准，包括CRRT体外循环血路吗？	该公司是接受CRRT体外循环产品注册的中国唯一一家公司。公司是否参与制定包括CRRT体外循环在内的国家标准？	1
董秘您好：贵公司进博会签约3亿余人民币订单，对公司业绩是否有提高，另外棕榈油是公司的主要原材料之一，近期不断新高，公司是否根据原材料价格增高对下游经销商提价？	请问董秘：贵公司在进博下了3亿多元的订单，公司业绩提高了吗？此外，棕榈油是该公司的主要原材料之一，近期棕榈油价格创下历史新高。那家公司会因为原材料价格的上涨而向下游的经销商提价吗？	1
请问截止2021年8月10日 股东人数是多少 谢谢	到2021年8月10日，股东人数是多少？谢谢。	1
目前新冠病毒的传染性复杂，传播能力强，经常会有产品和环境检测成阳性，公司的抗菌性PP材料具备抗菌性特点，未来防疫加强，是否很多产品（包括防疫医护产品、汽车、家电等）会普及抗菌性材料。公司募集资金扩大产能，是否也有基于这方面的考虑？	目前，新型冠状病毒具有复杂的传染性和较强的传播能力，产品和环境检测往往呈阳性。该公司的抗菌PP材料具有抗菌特性，未来将加强防疫。推广产品是否多(包括防疫保健品、汽车、家用电器等)抗菌材料。该公司集资扩大产能，也是基于这个想法吗？	1
你好.请问目前贵公司有什么比较大的项目在做.有没有在竞标比较大的项目.	你好。告辞了。贵公司目前有大型项目吗？在比赛中没有更大的项目吗？	1
你好，尊敬的董秘，请问，截止到12月1日，贵公司的股东户数是多少，谢谢？	请问亲爱的董秘，请问到12月1日，贵公司有多少股东？谢谢。	1
公司领导您好！请问截止2021.9.30公司股东人数是多少？谢谢！	你好，公司领导！到2021.9.30，公司股东数量是多少？谢谢。	1
非常感谢董秘及时认真的回答股东问题，问一下公司硫辛酸片剂的研发到什么程度了，有点不太明白，片剂研发很难么？还是要走一些必要的程序？片剂大致什么时候能转化成产能？	感谢董秘认真回答股东的问题。询问了该公司硫辛酸片的开发程度。我不太清楚。开发平板电脑难吗？还是我们需要经过一些必要的程序呢？这款平板电脑什么时候能转换成产能？	1
您好，公司5万吨乳酸新产能，产品是否已对外销售？谢谢！	请问公司新增5万吨乳酸产能，产品对外销售了吗？谢谢。	1
近日根据媒体报道称，双良节能年底硅片产能将达到50GW，上机数控在现有30GW基础上将再建设40GW，贵公司是如何考虑自身的扩产速度？是否会有市场份额下降的风险？	近日，据媒体报道，双良节能晶圆产能年底将达到50GW，网通将在现有30GW的基础上建设40GW。贵公司如何看待自己的生产扩张速度？有没有市场份额下降的风险？	1
董秘您好，我想问一下贵公司最新的股东人数是多少，谢谢！	董秘，您好。我想问一下贵公司最新的股东人数是多少？谢谢。	1
请问，公司是否运营正常？是否有未披露应披露的重大信息？	告辞了。公司运转正常吗？有需要公开的重要信息吗？	1
公司股价经常破净，管理层是否会增持股份，给广大股民信心？	公司股价经常被打破，管理层增持股份是否给广大股东以信心？	1
请问贵公司有没有接到元宇宙建筑相关的设计订单?另有没有计划向元宇宙方向发展的筹划?谢谢!	贵公司有没有接到过与梅塔巴斯建筑相关的设计订单？有没有其他的计划往元巴斯方向发展？谢谢。	1
公司能预计出3条产线分别什么时候才能达到设计产能状态？公司新接订单与去年同期相比增长多少？	该公司能预测这三条生产线何时达到设计产能？与去年同期相比，该公司收到的新订单增加了多少？	1
公司截止10.31股东人数多少？	截至10月31日，该公司的股东数量是多少？	1
您好董秘，请问截止2021年10月31日股东人数是多少？	董秘，您好，到2021年10月31日，股东人数是多少？	1
公司产品超高纯氯甲烷主要应用于什么方面？	该公司超高纯度氯甲烷的主要用途是什么？	1
请问董秘，贵公司未来生产经营有哪些科学有效措施？有无计划尽快提升业绩？有无回购计划？	董秘，贵公司今后将在生产经营中采取哪些科学有效的措施？你有没有计划尽快提高你的表现？有回购计划吗？	1
近1.1亿股，何时解禁流通？	近1.1亿股流通股何时解禁？	1
董秘你好！请问贵公司有什么产品应用于高铁上？	你好，董秘！有什么高铁产品？	1
董秘你好，请问贵公司有没有参与柔性直流工程的建设？如果没有，公司是否有这方面的技术储备？	董秘先生，请问贵公司是否参与柔性DC项目的建设？如果没有，该公司在这方面是否有技术储备？	1
请问公司是否有光伏和风电业务件生产，新能源汽车有哪些领域。华为供应商之一，包括哪些主要部件，谢谢回复。	请问该公司有光伏和风电组件的生产业务吗？新能源汽车有哪些领域？华为的供应商，包括哪些主要部件，谢谢您的回复。	1
请问贵公司目前为止回购股份了吗？	迄今为止，你的公司回购股票了吗？	1
请问董秘：公司是否有针对新冠疫情的特效药进行研发？	董秘：对于新冠肺炎的流行，公司有没有特效药的研发？	1
你好，据传闻，2022 年秋季将是苹果有史以来发布产品最多的季节，苹果在2021年第四季度占全球智能手机出货量的22%，重新成为全球智能手机市场的冠军。应该会大幅增加对公司产品需求吧？	您好，有传言称2022年秋季将是苹果历史上产品发布数量最多的季节。2021年第四季度，苹果占全球智能手机出货量的22%，再次位居全球智能手机市场榜首。公司对产品的需求会大幅增加，对吧？	1
你好,比亚迪汉dmi什么时间上市?等待中	您好，比亚迪韩DMI什么时候上市？等待(等待)	1
张总你好！贵公司股票上市当天就破发四季度经营情况和订单是否下滑？	你好，张先生！在你的股票上市当天，你公司第四季度的运营和订单下降了吗？	1
我是公司小股东，请问公司7月底的股东户数。公司中期预盈公告什么时候发布？	我是那个公司的少数股东。请问公司7月底的股东户数是多少？该公司中期业绩公告何时发布？	1
你好，请问截止2021年12月10日，公司股东人数多少？谢谢	您好，截至2021年12月10日，该公司股东数量是多少？谢谢你，谢谢	1
请问，10月17日解禁的4.271亿股，主要由哪些机构或个人持有？	请问10月17日解禁的4.271亿股主要由哪些机构或个人持有？	1
请问公司截至12月10日股东数是多少？谢谢	截至12月10日，该公司的股东数量是多少？谢谢你，谢谢	1
请问贵公司三季度生产和销售是不是大幅下滑？飞流直下三千尺是贵公司走势的表现，公司是否还有动力？	贵公司第三季度产销量是否大幅下降？从3000英尺高空流下的水流是贵公司发展趋势的象征。这家公司还有这个权力吗？	1
请问公司，公司在oled方面有没有产品应用和研发？	请问该公司是否在OLED方面进行产品应用和研发？	1
公司的产品有应用于新冠检测吗？	在新冠肺炎测试中使用了该公司的产品吗？	1
公司的雷达产品可否装备舰船，飞机，战车？	该公司的雷达产品能配备舰船、飞机、坦克吗？	1
尊敬的董秘 1.为什么贵公司股东要通过二级市场集中竞价的方式进行减持，不断的低价抛售压低市场价格，对股价造成冲击?为什么不考虑通过大宗交易的方式进行? 2.刚刚过去的黑五，网一安克销售表现如何，是否能够给年报带来积极影响，重大活动和节日的销售数据希望能够及时披露。 3.三季度末高库存是否有所改善?	尊敬的董秘1，为何贵公司股东通过二级市场集中竞价，持续低价抛售打压市场价格，冲击股价？为什么不考虑在大宗交易中做的事情呢？2、在过去的黑五中，网易安科销售业绩如何，能否对年报产生积极影响？希望及时披露重大活动和节日销售数据。3.高库存在第三季度末有改善吗？	1
3月31日股东人数多少，谢谢	3月31日的股东数量是多少？谢谢。	1
董秘好，请问公司在手订单有多少？谢谢	董秘你好。这家公司有多少订单？谢谢你，谢谢	1
宝，键合丝项目进展如何，环评通过了吗，产能现在有多少。	包、粘丝绸项目进展如何，环评通过了吗，现在产能多少？	1
请问公司产品在新冠检测试剂盒，药物，创新药等是否有应用	请问该公司的产品是用于新冠肺炎套件、药品、创新药等吗？	1
贵公司汽车电子业务是否包含IGBT汽车功率半导体产品？	贵公司的汽车电子业务包括IGBT汽车功率半导体吗？	1
董秘你好，12月22日下午尾盘出现暴跌，有市场传言是因为公司大客户出现取消订单，想了解一下公司目前产能利用率情况，新的一年大客户订单情况，希望董秘就可披露范围内信息进行回答，以防止恐慌情绪导致广大股东经济利益受损，谢谢。	你好，董秘。12月22日下午晚些时候出现大幅减少。市场上有传言称该公司的主要客户取消了订单。我想知道公司目前的产能利用率和新一年主要客户的订单情况。希望董秘回答披露范围内的信息，不要对大股东的经济利益产生恐慌。谢谢。	1
你好，看到公司已经提价，请问公司产品提价幅度是多少？	对不起，我看到公司涨价了。请问公司产品的涨价幅度是多少？	1
公司有股权质押和商誉情况吗？	公司是否拥有股票质押和商业权？	1
你好，请问今年四季度有没有增加新的产能，目前订单有如何？	请问今年第四季度你们增加产能了吗？目前的订单情况如何？	1
公司的核心产品是什么？今年前八个月，核心产品销售收入占公司全部销售收入的占比是多少，核心产品市场占有率是多少？	公司的核心产品是什么？今年前8个月，核心产品销售额占公司销售总收入的比例是多少，核心产品的市场份额是多少？	1
董秘您好，请问截止12月10日股东人数是多少？谢谢！	董秘，您好，到12月10日，股东人数是多少？谢谢。	1
公司应该更名伊利乳业，让投资者明白公司主业	该公司应改名为伊利乳业，让投资者了解公司的主要业务。	1
董秘您好，想了解一下美瞳产品后续有扩建产能的规划吗，大概完成时间和投资以及产能情况，谢谢。	董秘，您好。想知道扩大美容隐形眼镜产品产能的计划，以及大约完成时间和投资、产能吗？谢谢。	1
请问董秘，截止11月10日股东人数是多少？	请问董秘，到11月10日，股东人数是多少？	1
请问贵公司产品属于建筑节能领域吗？请说明一下，谢谢！	贵公司的产品属于建筑节能领域吗？请说明一下。谢谢。	1
公司是否有相关业务或者技术储备涉及到元宇宙这片蓝海？	公司是否拥有与梅塔弗斯蓝海相关的业务或技术储备？	1
20211102-20211201，三达膜(688101)高管合计减持73.94万股，占流通股比0.40%，市值1546.82万元，公司公告董监高合计减持不超过73.33万股。董秘麻烦解释一下也不违规？	2021102年度至20211201年度，散打片(688101)高管共减持739400股，占流通股的比例为0.40%，减持市值1，546.82万元。公司公告称，董监高所持股份不超过733300股。董秘，请解释一下。这有没有违规？	1
您好，请问贵公司1月10日的股东人数是多少？	请问贵公司1月10日的股东数量是多少？	1
公司大股东招标集团已承诺将集团旗下环保设计院、诚正造价等企业注入招标股份,未来将进一步拓宽公司业务覆盖领域,为公司加快发展环保双碳经济带来更多的战略资源,以打造公司生态环境全产业链发展新格局。请问是有注入预期吗	公司大股东招标集团承诺将旗下环保设计院、诚正成本等企业注入投标股份，将进一步扩大公司未来的业务覆盖面，为公司加快发展环保双碳经济带来更多战略资源。构建公司生态环境全产业链发展新格局。告辞了。你有注射的期望吗？	1
您好，请问永泰能源公司的知识产权情况如何，掌握哪些专利？储能方向转型目前拥有哪些核心技术？	您好，永泰能源有限公司拥有哪些知识产权？你有什么样的专利？能源储存转换的核心技术有哪些？	1
您好，请问，贵公司截止1月10日股东人数是多少？谢谢！	请问到1月10日，你们公司的股东人数是多少人？谢谢。	1
董秘，你好，公司郭总参加南京国际集成电路展览会，公司展示了哪些产品？有哪些创新亮点？	董秘，您好，郭先生出席了南京国际集成电路展览会。该公司展示什么样的产品？创新的亮点是什么？	1
董秘您好，请问截止到最新一个交易日11月1日，股东人数为多少	董秘你好。到11月1日，也就是到最新的交易日，股东人数是多少？	1
4月19日下午，中央全面深化改革委员会第二十五次会议召开，审议通过了《关于加强数字政府建设的指导意见》等政策文件，会议强调，要全面贯彻网络强国战略，把数字技术广泛应用于政府管理服务，推动政府数字化、智能化运行，为推进国家治理体系和治理能力现代化提供有力支撑。对公司智慧政务政务有何影响	4月19日下午，中央全面深化改革委员会第二十五次会议召开，审议通过了“关于加强数字政府建设的指导意见”等政策性文件。会议强调，要全面实施网络强国战略。将数字技术广泛应用于政府治理服务，推动政府数字化、智能化运行，为国家治理体系和治理能力现代化提供有力支撑。对公司智慧政务有何影响？	1
董秘你好，请问贵公司为钢铁厂提供屋顶光伏发电项目进展如何？是否有可研方案？谢谢！	董秘先生，您好，为钢厂提供屋顶太阳能发电的项目进展如何？有没有可行的研究计划？谢谢。	1
董秘你好，请问公司在生产硫酸、硫酸亚铁方面是否具备资源优势和成本优势？	董秘，您好。该公司在生产硫酸和硫酸亚铁方面有资源优势和成本优势吗？	1
尊敬的董秘：您好！       请问截至道11月低公司的股东户数是多少？ 谢谢！	尊敬的董秘：你好？请问11月份低端公司的股东户数是多少？谢谢。	1
请问贵公司未来会继续专注在谐波减速器业务上，还是说开辟新的产品线？比如RV减速器？公司的谐波减速器目前在四大机器人家族的业务拓展如何，有什么进展吗？	贵公司今后是继续专注于谐波减速机业务，还是开拓新的产品线？就像汽车减速机一样？公司谐波减速器四大机器人家族的业务是怎样的？有什么进展吗？	1
请问贵公司销售模式除了直销还有其他途径吗？	除了直销，还有其他办法推销你的公司吗？	1
贵公司说自己的半导体硅片生产“订单饱满，生产排期紧张，正在积极加快产能扩建”那公司今年产品价格相对于去年有没有提价？提价多少？	贵公司表示，其半导体晶圆生产“订单满满，生产进度吃紧，正在积极加快产能扩张”。与去年相比，该公司今年提高了产品价格吗？要涨多少钱？	1
您好 ,下游锂电池厂商都在大幅度扩产能,对公司产品需求量猛增,请问公司未来是否有扩产计划!	您好，下游锂电池制造商正在大幅扩大容量，对该公司产品的需求飙升。那家公司有计划将来扩大生产吗？	1
你好，董秘，现阶段光伏胶产能可以达到多少？	请问董秘，现阶段能生产多少光伏胶水？	1
公司产品能用在储能领域吗？	我们的产品适用于储能领域吗？	1
你好，贵公司展示的第四代6A万兆非屏蔽铜缆系统（获得国家专利）；支持90W 以太网供电，在10 Gbps压力测试下零误码的6A万兆屏蔽铜缆系统；具有高性能余量的6类千兆铜缆系统，大陆唯一通过Intertek传输性能和PoE耐久性测试的非屏蔽6类模块等创新产品 主要应用在哪？目前订单如何？	您好，贵公司支持第四代6A兆无屏蔽铜缆系统(国家专利)；6A兆屏蔽铜缆系统，支持90W以太网供电，10Gbps压力测试零错误；6A兆铜电缆系统、高性能裕度、大陆中国通过Intertek传输性能测试和PoE耐久性测试的6种无屏蔽铜缆系统等主要创新产品在哪里？现在的顺序是什么？	1
财联社6月1日讯，记者从金字火腿相关负责人处获悉，目前公司产能饱和，今年4月公司推出的新产品火锅火腿有望进入海底捞铺货，未来肉制品业务升级将成为利润增长点；公司年内将扩建2.4万吨储量的冷库项目；此外占地172亩用于火腿、香肠、酱肉等产品加工的超级工厂预计将在近期开建。请问上述新闻报道是否属实？	据金字火腿相关负责人透露，公司产能已经饱和，公司今年4月推出的新品火锅火腿有望进军海底渔店，未来肉类业务升级将成为利润增长点，公司今年将扩大24000吨储备冷库项目。此外，近期还将建设24000亩加工火腿、香肠、调味品等产品的超级工厂。请问上述报纸报道属实吗？	1
您好，请问截止6月30日，公司股东户数是多少？谢谢您！	请问到6月30日，公司股东人数是多少？非常感谢。	1
能否告知公司产品具体应用到华为的什么产品？比如是华为手机、笔记本、汽车等。谢谢。	能告诉我该公司适用于华为的产品吗？比如，华为手机、笔记本电脑、汽车等。谢谢。	1
你好 请问截至12月20日公司股东人数是多少？谢谢	请问到12月20日，该公司的股东人数是多少？谢谢你，谢谢	1
请问公司目前拿到的订单是什么情况？对于2、3季度的旺季，公司怎么看待市场的需求和赤糖的价格？对于全年的目标，企业有没有内部计划？	公司目前收到的订单情况如何？对于第二季度和第三季度的旺季，公司是如何看待红糖的市场需求和价格的？公司有年度目标的内部计划吗？	1
董秘，您好！请问截止10月29日收盘，公司股东户数是多少？谢谢！	董秘你好。截至10月29日的收盘价，该公司的股东数量是多少？谢谢。	1
你好。根据公司定期报告，目前产量是明显大于产能的，请问采取了哪些管理措施？公司的产能是按每天8小时计算的吗？谢谢！	你好。根据公司定期报告，目前的产量明显大于产能，采取了哪些管理措施？公司的产能是按每天8小时计算的吗？谢谢。	1
董秘你好，微逆核心技术是不是还未攻克，在各大平台我搜索不到公司微逆的产品？有没有考虑并购其他同类型厂商，来达到快速量产的目的？	抱歉，董秘，微反核心技术还没被攻克。能否在各大平台上搜索我们公司的微反产品？您有没有考虑过与其他类似的制造商合并，以达到快速量产的目标？	1
请问，是不是董监高的张安军先生减持时间过半或者减持数量过半时，需要披露减持进度报告，此类公告是不是属于自愿性披露？ 持股5%以上的君盛峰石是不是也适用同一条规定。以上，谢谢。 祝，商祺。	董监高的张安军先生减持过半或减收数量过半，是否需要披露进度报告？此类公告是否自愿披露？持股5%以上的均胜丰石是否也适用同样规则。上面，谢谢。许愿的话，尚奇。	1
公司产品应用在新能源汽车电机上吗？	该公司的产品用于新能源汽车电机吗？	1
您好，规模竞争是酒店集团发展的必经之路，君亭酒店目前在全国的一个战略布局情况是怎样的？	你好，规模竞争是酒店集团发展的必由之路。君亭酒店在国内的战略布局是什么？	1
董秘，请问1、贵公司与中科三安签订了战略合作协议，目前有哪些实质性的合作项目或业务在推进？2、截止目前，贵公司最新的持股人数是多少，麻烦你帮我们查询公布一下，让我们中小投资者到贵公司实地查询，不是很方便，麻烦你帮忙查下，谢谢！	董秘，打扰一下1。贵公司与中国科技萨南公司签订战略合作协议目前正在进行哪些实质性合作项目或业务？2.目前，贵公司的最新股东数量是什么？请帮助我们调查并公布这个消息。我们的中小投资者到贵公司现场咨询不太方便。请查收。谢谢。	1
公司股价自9月份下跌40%，远超行业和指数跌幅，你们应当深刻反思经营过失，启动管理层增持或者上市公司回购等方式来体现你们对公司价值的认同。	自9月以来，该公司股价已下跌40%，远高于行业和该指数的跌幅。你应该反思你的商业失误，反映管理层持有或回购上市公司，以及对公司价值的认可。	1
董秘你好，2021年 7月14日，上海申通地铁集团有限公司轨道交通培训中心（以下简称申通地铁培训中心）、郑州捷安高科股份有限公司（以下简称捷安高科）、上海叁昶文化科技有限公司（以下简称上海叁昶）三方在上海共同签署战略合作框架协议，对贵司未来发展有重大影响吗，谢谢！	您好，董秘，2021年7月14日，上海申通地铁集团有限公司轨道交通培训中心(以下简称申通地铁培训中心)、郑州捷安高新科技有限公司(以下简称捷安高新)、上海三昌文化科技有限公司(以下简称上海三昌)在上海共同签署战略合作框架协议，会对您未来的发展产生重大影响吗？谢谢。	1
请问截止到11月10日，公司股东人数是多少？谢谢！	截至11月10日，该公司的股东数量是多少？谢谢。	1
董秘你好！为什么定单饱满，天天加班安排生产！却没有预增预告，挣的钱都去什么地方了！	你好，董秘！为什么订单满了，每天加班安排生产呢！但是事先没有通知，赚的钱去哪儿了！	1
您好！公司20年人源重组蛋白和非人源重组蛋白的销售额分别为多少？人源重组蛋白和非人源重组蛋白销售平均价分别为多少？	你好！近20年来，人重组蛋白和非人重组蛋白的销售量分别为多少。人重组蛋白和非人重组蛋白的平均售价分别是多少？	1
公司植物胶囊三季度以来产能恢复情况如何。	三季度以来，该公司厂舱产能恢复情况如何？	1
董秘您好！截止6月30日，公司股东人数多少？谢谢！	董秘你好。到6月30日，股东人数是多少？谢谢。	1
贵司目前有新增那些战略合作客户呢？	您现在有哪些新的战略合作客户？	1
尊敬的董秘您好，看到贵公司经营项目含有：生态环境修复工程;环境治理，水体污染控制与治理，生态水景，土壤修复，小流域治理等，，，请问，对于环保项目，手上的订单项目有哪些，介绍一下，后期对环保项目更好的布局和扩充，麻烦您好好介绍下	尊敬的董秘，贵公司业务项目见过：生态环境修复项目、环境治理、水污染防治、生态水景、土壤修复、小流域治理等，对于环保项目，手头有哪些订单项目？请介绍后期环保项目的更好配置和扩展。	1
董秘您好，看到贵司发布2021-069号公告，皖东物流、杨凌东方富海、东方富海一号三家法人股东合计违规减持109,806股,合计成交总额11,300,030.32元。请问根据相关法律法规，以上违规减持所得收益是否需要缴纳公司，如需要缴纳，是否已于公告日缴纳完毕，谢谢！	董秘你好。我们看到贵公司发布了2021-069号通知。东物流、杨凌东方福海、东方福海1号三家法人股东违规减持股份109806股，合计13000 30.32元。根据相关法律法规，上述违规减持所得是否需要公司支付，如有必要，是否在公告当天支付，谢谢。	1
请问贵司目前股东数较国庆节前有何变化？现在世界经济低迷，贵司现有订单、生产所受负面影响是否严重，谢谢！	与国庆节前相比，贵公司股东数量有哪些变化？现在世界经济低迷。你们现有的订单和生产受到严重影响吗？谢谢。	1
贵公司有压铸一体化储备技术吗？	贵公司有压铸一体化储备技术吗？	1
请问当前股东户数是多少？ 另外贵司是不是有生产智能电网相关部件？	目前股东家庭的数量是多少？此外，贵公司是否生产智能电网相关组件？	1
请问贵公司新建产能何时达产？在手订单情况如何，较去年比增长多少？	请问贵公司的新产能什么时候可以投产？现有订单的状态如何？比去年增长了多少？	1
董秘：    您好！    查阅贵公司2021年度财务报告，硫幸酸系列产品2020年库存量82.97吨，2021年生产量2106.87吨，销售量869.35吨，生产量大大超过销售量，而2021年库存量只有98.15吨，从这数据上看逻辑不对啊？请问，是不是生产量统计口径与销售量统计口径不一致？	董秘：你好。根据贵公司2021年财务报告，2020年硫磺酸系列产成品库存为82.97万吨，2021年为2106.87吨，2021年为869.35吨。请问生产统计的口径和销售统计的口径不一致吗？	1
您好，请问，贵公司截止8月10日股东人数是多少？谢谢！	请问到8月10日，你们公司的股东人数是多少人？谢谢。	1
董秘您好，请问战略配售增持是因为关联方看好本公司成长性吗？与您本人有关联吗？公司今年的增长点和着重发力点是在哪里？	董秘，您好。战略配售增效是因为相关人员看到我们公司的增长吗？这跟你有关系吗？公司今年的增长点和重点是什么？	1
请问，截至2021年12月20日，公司的股东数是多少？谢谢	请问到2021年12月20日，该公司的股东数量是多少？谢谢你，谢谢	1
董秘您好！贵公司作为新兴供暖节能产业，恰逢碳中和落地之年，前景无限，贵公司是否有扩大产业模式或者增持自家股票的意愿？	董秘你好。贵公司作为新型供热节能行业，恰逢碳中和年，前景无限。贵公司是否有意扩大其产业模式或增持股票？	1
公司在手的订单是否充足？ 还招聘人手不？	公司手头有足够的订单吗？你还在招人吗？	1
您好截止1月20日股东人数是多少谢谢。	您好，到1月20日的股东人数是多少？谢谢。	1
原材料涨价对公司的利润是否有影响？公司对四季度前景如何展望？	原材料涨价对公司利润有影响吗？该公司第四季度的展望是什么？	1
目前C919主要用T300级别的，今年开始交付了，请问贵公司当下有没有参与C919的供货？	目前，C919主要使用T300级别，已于今年交付。贵公司目前是否参与C919的供应？	1
提花面料对设计研发要求较高，而贵公司设计研发65人，但全公司本科及以上仅29人，设计研发部经理履历也并不出色，请问公司在设计研发方面的竞争力从何而来？是否有扩大人才队伍或增加设计研发投入的打算？	提花面料对设计研发要求很高，贵公司有65名设计研发人员，但公司本科以上学历仅29人，设计研发经理履历不优秀。该公司在设计和研发方面的竞争力从何而来？有没有计划扩大人才队伍或增加在设计研发方面的投入？	1
公司上市至今业债平平，产品应用也设有新的突破是否考虑并购优质企业拓展双主业发展	公司上市以来，债务表现平平，产品应用也有了新突破。是否考虑到M&A优质企业拓展双本行业的发展？	1
董秘你好，贵公司的产品在日常生活中，智能清洁后，可以起到杀菌消毒吗？贵公司产品上可以装备消毒杀菌药物等等，让产品自己在清洁区域启动功能这些效果，公司电机配件这么牛，以后可以用在元宇宙一些产品上吗？	请问董秘，您的产品智能清洗后，可以在日常生活中杀菌消毒吗？贵公司的产品可以配备消毒杀菌剂等，产品可以在清洁区域启动自己的功能。该公司的马达零件真厉害。将来可以用在一些超音响产品上吗？	1
成都天兴仪表质押（2017年100％）到现在，是不是已经穿仓了？为什么还在质押中？	成都天星仪器质押(2017 100%)到目前为止，是否已经过仓？为什么还入会呢？	1
全球航运费大幅上升是否影响公司经营业绩？	全球运费的大幅上涨是否会影响公司的经营业绩？	1
贵公司上市短短几个月破发近45%，能否用闲置资金回购公司股票	你的公司上市短短几个月就破了近45%，你能用闲置资金回购公司的股票吗？	1
董秘好，公司股票表现这么差，既然有大量的现金，为何不用在企业经营生产上？是没有业务量吗？不考虑回购自己公司股票去要增发？管理层是出于什么原因考虑的？	董美浩，公司的股票这么差。既然有很多现金，为什么不在企业的经营或生产中呢？没有业务量吗？难道不考虑通过回购自己的股票来进行配股吗？管理层考虑的原因是什么？	1
董秘你好，鉴于目前公司经营不善，有没有意向将公司大部分股权转让给盐津铺子的想法，或许拥抱盐津铺子会获好的成长空间？	请问董秘，考虑到目前公司治理不善，是否有意将公司大部分股份转让给盐津店，或者拥抱盐津店有良好的成长空间？	1
九安医疗是否是公司的客户？	久安医疗是该公司的客户吗？	1
￼ 尊敬的董秘您好！请问7月20日公司股东人数多少？谢谢！	尊敬的董秘先生您好。7月20日，该公司的股东数量是多少？谢谢。	1
贵公司或者子公司或者参与基金是否有参与元宇宙研发或者投资元宇宙项目	您的公司或子公司或参与基金是否参与了元巴斯的研发，或投资于元伯斯项目？	1
董秘您好，留意到公司在12月13日接受机构调研时表示，“公司在东莞松山湖试验基地已初步得到华为车载的认可，已逐步建立合作订单”。请问与华为车载的合作订单是哪方面零部件或功能模块的订单？谢谢。	董秘你好，该公司12月13日接受机构调查时注意到，该公司东莞松山湖试验基地已获得华为初步认可，逐步打造合作订单。请问与华为的合作订单是哪些组件或功能模块？谢谢。	1
你好贵公司募集资金已到位，请问是否已开工建厂扩大产能	你好，贵公司已经募集资金了。为了扩大产能，你们开始建厂了吗？	1
贵司目前有哪些大客户？订单是否满负荷？	贵公司目前的主要客户是什么？点菜加满了吗？	1
董秘好，通常集成就是买别人的产品再二次开发交付，那么请问贵公司的优势是什么?公司有什么亮眼的技术储备吗？公司是否有承包过储能相关项目?	董秘不错啊。平时的整合就是买别人的产品来重新开发和交付，但是你的公司有什么好处？这家公司有什么高明的技术储备吗？该公司是否承担了所有与能源储存有关的项目？	1
公司下半年有无重启动力煤业务的尝试？	该公司是否尝试在下半年恢复动力煤业务？	1
请问，公司股价跌跌不休，公司高层有没有增持计划?利津的项目如果实施，是用到上市的募集资金，还是再进行定向融资？	请问公司股价在下跌，公司高层是否有增收计划？如果利津项目到位，是用上市募集资金，还是进行定向融资？	1
董秘你好，请问公司是否有汽车相关业务，是否与知名新能源汽车制造企业、汽车零部件企业有相关合作？谢谢！	请问董秘，公司有汽车相关业务吗？与知名新能源汽车制造商、汽车零部件企业有相关合作吗？谢谢。	1
您好董秘，贵公司风能发电，水动力发电以及太阳能新能源等领域业务能简单介绍一下吗？以及新材料应用在哪些方面？谢谢	请问可以简单介绍一下董秘、风电、水电、太阳能领域的业务吗？什么是新材料的应用？谢谢你，谢谢	1
您好，请问截止8月31日，公司股东户数是多少？谢谢您！	请问到8月31日，公司股东户数是多少？非常感谢。	1
请问公司是元宇宙公司Oculus的零件供应商吗？	请问该公司是原航天公司Oculus的零部件供应商吗？	1
距离贵公司发布回购股票公告之日已接近俩月，贵公司并未实质性回购股票，公司高管不认可现在股票价格？	贵公司发布股份回购公告已近两个月，但贵公司尚未实际回购股票。公司高管是否认同目前的股价？	1
您好！最近新闻曝出抽检女装染料致癌物超标，请问贵公司的产品有被抽检到没有？贵公司产品染料符合标准吗？	你好！最近，据报道女性染料致癌物质超标。你们的产品被抽查了吗？贵公司的染料符合标准吗？	1
您好，请问贵公司可以披露一下12-30日最新的股东人数吗	请问贵公司截至12月30日的最新股东人数是多少？	1
尊敬的董秘您好，请问截止今日，股东人数多少？	您好，亲爱的董秘，到今天为止，股东人数是多少？	1
贵司的技术既然能得到那么多制药巨头的青睐，为什么反而没有和众多的国内做创新药和想转型的传统药企合作，做出更多真正的创新药？面对巨大的国内创新需求，公司有什么战略行动吗？	既然你的技术能获得这么多医药巨头的追捧，为什么不与国内许多想要转型的创新药物和传统药企合作，制造更多真正的创新药物？面对国内巨大的创新需求，公司有什么战略性动作吗？	1
请问贵公司苏州万盛祥能源科技有限公司的新能源汽车动力电池零组件都生产什么？有什么专利或特殊的工艺？与其它别的厂家的产品有什么不同？核心竞争力有什么？	请问贵公司苏州万盛祥能源科技有限公司生产的新能源汽车动力电池模块是什么？有什么专利或者特别技术吗？它与其他制造商的产品有什么区别？什么是核心竞争力？	1
请问，截至2021年11月24日，公司的股东数是多少？谢谢！！	请问到2021年11月24日，该公司的股东数量是多少？谢谢。	1
请问公司有在研发全空间环境的‘ 室内隔空“无线充电” ’技术吗？ 是否有相关技术储备。	该公司是否在开发全空间环境下的室内空间无线充电技术？是否有相关的技术储备。	1
尊敬的董秘：请问公司是否有编制企业十四五发展规划，对于这期间的主营业务占比是否有相应的战略规划调整。谢谢	尊敬的董秘：请问公司是否编制了十四、五计划？其间主业务占比是否有相应的战略规划调整？谢谢你，谢谢	1
请问截止11月10日，公司股东人数和机构数量，谢谢！	截至11月10日，公司股东和机构数量，谢谢！	1
请问蔚来汽车是公司的客户吗？	告辞了。蔚来是该公司的客户吗？	1
截至今日，股东人数多少？	到今天为止的股东数是多少？	1
您好，请问贵公司的产品有应用在氢反应器等氢能源设备上吗？	请问您的产品是用于氢反应堆等氢能设备吗？	1
请问目前为止，公司有哪些子公司是从事养殖行业的？	到目前为止，该公司的哪些子公司从事养殖业？	1
董秘您好，请问贵司截止到1月20日收盘的股东户数是多少？感谢。	董秘，您好，截至1月20日，贵公司股东账户数量是多少？谢谢。	1
请问贵公司目前拥有多少项技术专利？	贵公司目前拥有多少技术专利？	1
董秘您好！最近互动平台投资者问到公司签订订单的一些金额情况，公司为什么不敢正面回答？如果你们不告诉我们，大家怎么能知道公司亏损情况？谢谢！	董秘你好。近日，互动平台上的投资者询问了该公司签署的部分订单金额，为什么该公司不能直接回答？如果你没有告诉我们，你怎么会知道公司的损失？谢谢。	1
请问董秘，公司产品中是否有可用于储能的逆变器？	请问董秘，公司产品中有没有可以用于储能的逆变器？	1
董秘你好，也就是说公司的三维激光扫描技术是元宇宙的底层技术之一，只是公司现在还没有建设元宇宙的订单，是这样吗？	您好，董秘，也就是该公司的三维激光扫描技术是元巴斯的底层技术之一，但该公司还没有下令建造元巴斯吗？	1
尊敬的董秘，您好，请问截止12月20日，贵司股东户数是多少？谢谢。	尊敬的董秘，你好？截至12月20日，贵公司的股东人数是多少？谢谢。	1
